吉野家,埼玉県,かるびのとりこ 川越上寺山店,埼玉県川越市大字上寺山520‐2,1200,20251011,1150,50
吉野家,埼玉県,吉野家 鳩ヶ谷店,埼玉県川口市三ツ和2丁目12‐1,1200,20251011,1150,50
松屋,埼玉県,松のや ふじみ野店/マイカリー食堂 ふじみ野店,埼玉県富士見市ふじみ野西1-20-2 第7マツモトビル106,1200,20251011,1150,50
松屋,東京都,松のや 綾瀬店,東京都足立区綾瀬4-7-1,1250,20251011,1226,24
松屋,千葉県,松のや 松戸店,千葉県松戸市本町4-4 GK松戸ビル,1150,20251011,1140,10
松屋,奈良県,松のや 上牧店,奈良県北葛城郡上牧町大字上牧3344番1（地番）,1051,20251011,1050,1
松屋,埼玉県,松のや 西川口店/マイカリー食堂 西川口店,埼玉県川口市西川口1-22-20 西川口ビル1F,1150,20251011,1100,50
松屋,埼玉県,松のや 川越西口店/マイカリー食堂 川越西口店,埼玉県川越市脇田本町6-8,1200,20251011,1150,50
松屋,埼玉県,松のや 草加店,埼玉県草加市氷川町2121-3,1200,20251011,1150,50
松屋,埼玉県,松のや 大宮店,埼玉県さいたま市大宮区宮町1-50-2 いとや宮町ビル2F,1250,20251011,1200,50
松屋,奈良県,松のや 大和高田店,奈良県大和高田市曽大根122-7,1051,20251011,1050,1
松屋,埼玉県,松のや 朝霞台店,埼玉県朝霞市浜崎1-3-10AX-1ビル,1200,20251011,1150,50
松屋,埼玉県,松のや 南越谷店/マイカリー食堂 南越谷店,埼玉県越谷市南越谷1-19-2,1200,20251011,1150,50
松屋,埼玉県,松屋 さいたま見沼店/松のや さいたま見沼店,埼玉県さいたま市見沼区新堤94-1,1200,20251011,1100,100
松屋,埼玉県,松屋 浦和所沢バイパス店,埼玉県富士見市水谷東1-1-2,1230,20251011,1200,30
松屋,埼玉県,松屋 桶川店,埼玉県桶川市坂田1632-1,1200,20251011,1150,50
松屋,静岡県,松屋 掛川SC(下り線)店,静岡県掛川市倉真5968-4,1097,20251011,1050,47
松屋,福岡県,松屋 干隈店/松のや 干隈店/松のや 干隈店/松のや 干隈店,福岡県福岡市早良区干隈3-29-6,1057,20251011,1000,57
松屋,埼玉県,松屋 熊谷バイパス店/松のや 熊谷バイパス店,埼玉県熊谷市大字肥塚1408-3,1200,20251011,1150,50
松屋,埼玉県,松屋 高坂店,埼玉県東松山市元宿1-11-2,1200,20251011,1180,20
松屋,埼玉県,松屋 坂戸店,埼玉県坂戸市南町34-5,1200,20251011,1180,20
松屋,福岡県,松屋 糸島店,福岡県糸島市神在西2丁目22番30号,1057,20251011,1000,57
松屋,埼玉県,松屋 上尾東口店,埼玉県上尾市宮本町3-16,1200,20251011,1150,50
松屋,埼玉県,松屋 上尾緑丘店/松のや 上尾緑丘店,埼玉県上尾市緑丘3-3-7,1200,20251011,1150,50
松屋,埼玉県,松屋 新座馬場店,埼玉県新座市馬場1-4-13,1230,20251011,1200,30
松屋,埼玉県,松屋 深谷市役所前店,埼玉県深谷市深谷町4-45,1200,20251011,1150,50
松屋,埼玉県,松屋 吹上店,埼玉県鴻巣市鎌塚3-10-12,1200,20251011,1150,50
松屋,埼玉県,松屋 大宮深作店,埼玉県さいたま市見沼区深作3-27-3,1200,20251011,1100,100
松屋,埼玉県,松屋 大宮南中丸店/松のや 大宮南中丸店,埼玉県さいたま市見沼区大字南中丸519-4,1200,20251011,1100,100
松屋,埼玉県,松屋 朝霞泉水店/松のや 朝霞泉水店,埼玉県朝霞市泉水1-7-9,1230,20251011,1200,30
松屋,埼玉県,松屋 朝霞台店,埼玉県朝霞市浜崎1-3-10 AX-1ビル1F,1230,20251011,1200,30
松屋,埼玉県,松屋 朝霞店,埼玉県朝霞市本町2-4-18,1230,20251011,1200,30
松屋,埼玉県,松屋 朝霞東口店,埼玉県朝霞市仲町2-2-43 大日屋ビル,1230,20251011,1200,30
松屋,埼玉県,松屋 朝霞膝折店,埼玉県朝霞市膝折町2-10-14,1230,20251011,1200,30
松屋,埼玉県,松屋 東松山上野本店/松のや 東松山上野本店,埼玉県東松山市上野本1174-2,1200,20251011,1180,20
松屋,埼玉県,松屋 東松山店,埼玉県東松山市箭弓町1-12-8,1200,20251011,1180,20
松屋,埼玉県,松屋 東大宮駅前店/マイカリー食堂 東大宮駅前店,埼玉県さいたま市見沼区東大宮5-38-5,1200,20251011,1100,100
松屋,埼玉県,松屋 東大宮店,埼玉県さいたま市見沼区東大宮5-10-5,1200,20251011,1100,100
松屋,群馬県,松屋 藤岡店/松のや 藤岡店,群馬県藤岡市上大塚317-1（地番）,1200,20251011,1150,50
松屋,福岡県,松屋 那珂川店/松のや 那珂川店,福岡県那珂川市片縄北6-17-8,1057,20251011,1050,7
松屋,埼玉県,松屋 北浦和店,埼玉県さいたま市浦和区北浦和4-3-8 USビル1F,1200,20251011,1150,50
松屋,埼玉県,松屋 北本店,埼玉県北本市深井6-151,1200,20251011,1150,50
松屋,埼玉県,松屋 本庄店/松のや 本庄店,埼玉県本庄市けや木3-2769、他2筆,1200,20251011,1150,50
松屋,埼玉県,松屋 野火止店,埼玉県新座市野火止4-7-29,1230,20251011,1200,30
松屋,埼玉県,松屋 与野駅前店,埼玉県さいたま市浦和区上木崎1-4-2,1200,20251011,1150,50
松屋,埼玉県,松屋 蓮田関山店/松のや 蓮田関山店,埼玉県蓮田市関山2-7-7,1200,20251011,1150,50
松屋,埼玉県,松屋 蓮田店,埼玉県蓮田市東5-2-9,1200,20251011,1150,50
