松屋,東京都,松のや ひばりが丘店/マイカリー食堂 ひばりが丘店,東京都西東京市ひばりが丘北4-1-32,1200,20230304,1100,100
松屋,埼玉県,松のや ふじみ野店/マイカリー食堂 ふじみ野店,埼玉県富士見市ふじみ野西1-20-2 第7マツモトビル106,1150,20230304,1100,50
松屋,千葉県,松のや 行徳店/マイカリー食堂 行徳店,千葉県市川市行徳駅前2-3 ポニー行徳商業ビル,1200,20230304,1100,100
松屋,東京都,松のや 三鷹店,東京都武蔵野市中町1-14-5 1F,1250,20230304,1200,50
松屋,千葉県,松のや 市川店/マイカリー食堂 市川店,千葉県市川市市川1丁目4-16,1100,20230304,1000,100
松屋,千葉県,松のや 松戸新田店,千葉県松戸市松戸新田289-6,1200,20230304,1050,150
松屋,千葉県,松のや 松戸店,千葉県松戸市本町4-4 GK松戸ビル,1100,20230304,1000,100
松屋,東京都,松のや 沼袋店/マイカリー食堂 沼袋店,東京都中野区沼袋3-27-6 リバティハイツ高橋,1150,20230304,1100,50
松屋,東京都,松のや 上板橋店,東京都板橋区常盤台4-32-6,1150,20230304,1100,50
松屋,東京都,松のや 新秋津店,東京都東村山市秋津町5-13-7,1200,20230304,1100,100
松屋,茨城県,松のや 神栖店,茨城県神栖市大野原3-11-2,1100,20230304,1000,100
松屋,埼玉県,松のや 西川口店/マイカリー食堂 西川口店,埼玉県川口市西川口1-22-20 西川口ビル1F,1100,20230304,1000,100
松屋,東京都,松のや 西東京新町店/マイカリー食堂 西東京新町店,東京都西東京市新町4-6-7,1150,20230304,1072,78
松屋,東京都,松のや 赤羽店,東京都北区赤羽1-17-1,1200,20230304,1100,100
松屋,東京都,松のや 千川店,東京都豊島区要町3-11-1,1200,20230304,1100,100
松屋,千葉県,松のや 千葉店/マイカリー食堂 千葉店,千葉県千葉市中央区富士見2-24-1,1200,20230304,1050,150
松屋,千葉県,松のや 千葉都町店/マイカリー食堂 千葉都町店,千葉県千葉市中央区都町4-6-1,1100,20230304,1050,50
松屋,埼玉県,松のや 川越西口店/マイカリー食堂 川越西口店,埼玉県川越市脇田本町6-8 栄光ビル1F,1150,20230304,1100,50
松屋,埼玉県,松のや 川口店,埼玉県川口市川口1-1-1 CuPo・La専門店A107,1200,20230304,1100,100
松屋,埼玉県,松のや 草加店,埼玉県草加市氷川町2121-3,1100,20230304,1000,100
松屋,埼玉県,松のや 大宮店,埼玉県さいたま市大宮区宮町1-50-2 いとや宮町ビル2F,1100,20230304,1000,100
松屋,埼玉県,松のや 朝霞台店,埼玉県朝霞市浜崎1-3-10AX-1ビル,1100,20230304,1000,100
松屋,埼玉県,松のや 南越谷店/マイカリー食堂 南越谷店,埼玉県越谷市南越谷1-19-2アバンセ南越谷,1150,20230304,1000,150
松屋,千葉県,松のや 南行徳店,千葉県市川市相之川4-8-2,1100,20230304,1000,100
松屋,東京都,松のや 板橋店,東京都北区滝野川7-9-10 マインエントピア,1200,20230304,1100,100
松屋,東京都,松のや 武蔵境店,東京都武蔵野市境2-2-18 MHビル,1150,20230304,1100,50
松屋,東京都,松のや 武蔵小金井店,東京都小金井市本町5-18-5 太平ビル1F,1150,20230304,1100,50
松屋,千葉県,松のや 北小金店,千葉県松戸市小金8,1100,20230304,984,116
松屋,千葉県,松のや 幕張本郷店,千葉県千葉市花見川区幕張本郷1-3-7,1100,20230304,1000,100
松屋,千葉県,松のや 茂原店,千葉県茂原市高師台3-1-4,1100,20230304,1000,100
松屋,東京都,松のや 野方店/マイカリー食堂 野方店,東京都中野区野方5-25-4,1150,20230304,1100,50
松屋,東京都,松のや 練馬店,東京都練馬区豊玉北5-19-12,1250,20230304,1200,50
松屋,埼玉県,松のや 蕨西口店/マイカリー食堂 蕨西口店,埼玉県蕨市中央1-23-1,1200,20230304,1100,100
松屋,茨城県,松屋 かすみがうら店,茨城県かすみがうら市上稲吉1943-32,1040,20230304,1000,40
松屋,茨城県,松屋 ひたちなか店,茨城県ひたちなか市市毛字原坪894-36,1050,20230304,1000,50
松屋,埼玉県,松屋 ふじみ野店,埼玉県ふじみ野市ふじみ野1-9-21,1100,20230304,1000,100
松屋,東京都,松屋 渋谷清水橋店,東京都渋谷区本町3-39-3,1250,20230304,1200,50
松屋,東京都,松屋 小滝橋通り店,東京都新宿区西新宿7-7-28,1250,20230304,1200,50
松屋,東京都,松屋 新宿西口店,東京都新宿区西新宿1-13-3,1300,20230304,1200,100
松屋,東京都,松屋 新小岩店,東京都葛飾区新小岩1-46,1200,20230304,1150,50
松屋,東京都,松屋 新小岩北口店,東京都葛飾区西新小岩1-9-1,1200,20230304,1150,50
松屋,茨城県,松屋 水戸バイパス店,茨城県水戸市元吉田町1435-7,1100,20230304,1000,100
松屋,茨城県,松屋 水戸東原店/松のや 水戸東原店,茨城県水戸市東原1‐3‐17,1100,20230304,1000,100
松屋,東京都,松屋 西新宿3丁目店,東京都新宿区西新宿3-7-21,1250,20230304,1200,50
松屋,東京都,松屋 西新宿8丁目店,東京都新宿区西新宿8-12-1,1300,20230304,1200,100
松屋,東京都,松屋 西新宿タワー60店/マイカリー食堂 西新宿タワー60店,東京都新宿区西新宿5-5-1 ザ・パークハウス西新宿60 A103号室,1300,20230304,1200,100
松屋,東京都,松屋 西新宿店,東京都新宿区西新宿5-10-14,1250,20230304,1200,50
松屋,埼玉県,松屋 川越インター店,埼玉県川越市広栄町6-6,1050,20230304,1000,50
松屋,埼玉県,松屋 川越城下町店,埼玉県川越市城下町7-8,1100,20230304,1050,50
松屋,埼玉県,松屋 川越西口店,埼玉県川越市脇田本町1-7 川越駅西口ビル,1050,20230304,1030,20
松屋,埼玉県,松屋 川島店/松のや 川島店,埼玉県比企郡川島町大字上伊草1214-1,1100,20230304,1050,50
松屋,東京都,松屋 大久保店,東京都新宿区百人町1-18-11,1250,20230304,1200,50
松屋,東京都,松屋 中野坂上店,東京都中野区中央2-1-2,1300,20230304,1200,100
松屋,千葉県,松屋 津田沼店,千葉県習志野市津田沼1-10-41 十番街ビル1F,1200,20230304,1100,100
松屋,千葉県,松屋 津田沼南口店,千葉県習志野市谷津7-9-16 京葉ビル2,1200,20230304,1100,100
松屋,埼玉県,松屋 鶴瀬店,埼玉県富士見市鶴馬2605-1,1050,20230304,1000,50
松屋,東京都,松屋 東中野店,東京都中野区東中野3-1-19,1250,20230304,1200,50
松屋,埼玉県,松屋 南浦和店,埼玉県さいたま市南区南浦和2-36-16 田中ビル,1200,20230304,1100,100
松屋,茨城県,松屋 日立桜川町店,茨城県日立市桜川町2-4-12,1000,20230304,950,50
松屋,埼玉県,松屋 本川越店,埼玉県川越市新富町2-33-1,1050,20230304,1030,20
松屋,埼玉県,松屋 蕨西口店,埼玉県蕨市中央1-23,1200,20230304,1100,100
松屋,埼玉県,松屋 蕨店,埼玉県蕨市塚越1-4-4 ,1200,20230304,1100,100
松屋,埼玉県,松屋 蕨北町店,埼玉県蕨市北町5-4-5,1200,20230304,1100,100
すき家,京都府,すき家 1国山科西野店,京都府京都市山科区西野山階町11-5,1050,20230304,1000,50
すき家,北海道,すき家 228号北斗七重浜店,北海道北斗市七重浜7-2-1,980,20230304,960,20
すき家,沖縄県,すき家 329号西原店,沖縄県中頭郡西原町字我謝786-2,980,20230304,930,50
すき家,沖縄県,すき家 329号那覇古波蔵店,沖縄県那覇市古波蔵3-14-2,1000,20230304,950,50
すき家,沖縄県,すき家 329号那覇上間店,沖縄県那覇市上間276-1,980,20230304,930,50
すき家,沖縄県,すき家 329号北中城店,沖縄県中頭郡北中城村字渡口456-3,980,20230304,920,60
すき家,沖縄県,すき家 330号浦添内間店,沖縄県浦添市内間2-6-92F,980,20230304,930,50
すき家,沖縄県,すき家 331号糸満店,沖縄県糸満市潮平603-1,980,20230304,930,50
すき家,愛知県,すき家 41号大口店,愛知県丹羽郡大口町中小口3-72-1,1050,20230304,1030,20
すき家,愛知県,すき家 41号豊山店,愛知県西春日井郡豊山町青山字江川73-1,1050,20230304,1030,20
すき家,沖縄県,すき家 507号八重瀬店,沖縄県島尻郡八重瀬町字伊覇46-4,950,20230304,930,20
すき家,沖縄県,すき家 58号宜野湾大謝名店,沖縄県宜野湾市字大謝名70-2,980,20230304,930,50
すき家,沖縄県,すき家 58号読谷店,沖縄県中頭郡読谷村伊良皆661-1,950,20230304,900,50
すき家,沖縄県,すき家 58号名護東江店,沖縄県名護市東江5-6517-1,1000,20230304,950,50
すき家,北海道,すき家 5号函館亀田店,北海道函館市亀田町17-11,980,20230304,960,20
すき家,沖縄県,すき家 イオン那覇店,沖縄県那覇市金城5-10-2イオン那覇1F,930,20230304,900,30
すき家,和歌山,すき家 ラウンドワン和歌山店,和歌山県和歌山市小雑賀739-3,1000,20230304,950,50
すき家,三重県,すき家 伊勢西IC店,三重県伊勢市勢田町419-6,1030,20230304,1000,30
すき家,岐阜県,すき家 可児下恵土店,岐阜県可児市下恵土字広瀬5890-1-1,1050,20230304,1030,20
すき家,京都府,すき家 京都太秦店,京都府京都市右京区常盤東ノ町6-3,1050,20230304,1000,50
すき家,愛知県,すき家 犬山五郎丸店,愛知県犬山市五郎丸東3-7-1,1050,20230304,1030,20
すき家,青森県,すき家 五所川原唐笠柳店,青森県五所川原市大字唐笠柳字藤巻521-8,980,20230304,920,60
すき家,愛知県,すき家 江南大間店,愛知県江南市大間町新町159-1,1050,20230304,1030,20
すき家,愛知県,すき家 春日井桃山店,愛知県春日井市桃山町3-224-2,1080,20230304,1050,30
すき家,愛知県,すき家 小牧春日寺店,愛知県小牧市春日寺2-329,1050,20230304,1030,20
すき家,京都府,すき家 西京区樫原店,京都府京都市西京区樫原分田16-3,1050,20230304,1000,50
すき家,沖縄県,すき家 那覇曙店,沖縄県那覇市曙2-23-1,950,20230304,930,20
すき家,沖縄県,すき家 那覇真嘉比店,沖縄県那覇市真嘉比3-15-16,980,20230304,950,30
すき家,北海道,すき家 函館漁火通店,北海道函館市広野町3-3,980,20230304,960,20
すき家,北海道,すき家 函館鍛治店,北海道函館市鍛治2-9-11,980,20230304,960,20
すき家,愛知県,すき家 扶桑柏森店,愛知県丹羽郡扶桑町大字柏森字西屋敷156-1,1050,20230304,1030,20
すき家,沖縄県,すき家 豊見城名嘉地店,沖縄県豊見城市名嘉地277-2,980,20230304,930,50
すき家,沖縄県,すき家 北谷国体道路店,沖縄県中頭郡北谷町上勢頭544-6,1000,20230304,930,70
すき家,愛知県,すき家 北名古屋弥勒寺店,愛知県北名古屋市弥勒寺東3-1,1050,20230304,1030,20
すき家,和歌山,すき家 和歌山秋月店,和歌山県和歌山市秋月304-5,1000,20230304,950,50
