吉野家,青森県,吉野家 102号線弘前高田店,青森県弘前市高田5丁目2‐4,900,20230225,870,30
吉野家,宮崎県,吉野家 10号線延岡店,宮崎県延岡市別府町3723‐1,930,20230225,900,30
吉野家,宮崎県,吉野家 10号線都城店,宮崎県都城市平江町5‐6,930,20230225,900,30
吉野家,福岡県,吉野家 10号線片野店,福岡県北九州市小倉北区片野2丁目21‐30,1000,20230225,950,50
吉野家,栃木県,吉野家 121号線鹿沼店,栃木県鹿沼市茂呂1059‐6,1030,20230225,1000,30
吉野家,埼玉県,吉野家 122号線石神店,埼玉県川口市石神685‐1,1100,20230225,1050,50
吉野家,埼玉県,吉野家 122号線川口店,埼玉県川口市朝日1丁目8‐6,1100,20230225,1050,50
吉野家,茨城県,吉野家 123号線茨城大学前店,茨城県水戸市堀町1066‐1,980,20230225,930,50
吉野家,埼玉県,吉野家 125号線栗橋店,埼玉県久喜市栗橋東5丁目10‐14,1100,20230225,1050,50
吉野家,埼玉県,吉野家 125号線行田桜町店,埼玉県行田市桜町1丁目23‐5,1050,20230225,1000,50
吉野家,北海道,吉野家 12号線岩見沢店,北海道岩見沢市日の出町8‐20,1000,20230225,980,20
吉野家,北海道,吉野家 12号線厚別東店,北海道札幌市厚別区厚別東4条3丁目24‐71,1030,20230225,980,50
吉野家,埼玉県,吉野家 140号線花園インター店,埼玉県深谷市小前田476‐3,1150,20230225,1050,100
吉野家,埼玉県,吉野家 140号線秩父店,埼玉県秩父市中宮地町4‐24,1050,20230225,1000,50
吉野家,長野県,吉野家 141号線佐久平店,長野県佐久市佐久平駅南19‐1,1000,20230225,960,40
吉野家,愛知県,吉野家 155号線常滑店,愛知県常滑市虹の丘7丁目98,1100,20230225,1000,100
吉野家,愛知県,吉野家 155号線新舞子店,愛知県知多市新舞子大口206‐7,1030,20230225,1000,30
吉野家,奈良県,吉野家 163号線生駒店,奈良県生駒市北田原町2476‐18,1000,20230225,950,50
吉野家,大阪府,吉野家 163号線門真店,大阪府門真市寿町21‐30,1100,20230225,1050,50
吉野家,奈良県,吉野家 168号線香芝店,奈良県香芝市上中745‐1,1000,20230225,930,70
吉野家,奈良県,吉野家 168号線東生駒店,奈良県生駒市辻町249‐1,1000,20230225,930,70
吉野家,奈良県,吉野家 169号線桜井店,奈良県桜井市川合263‐1,1000,20230225,930,70
吉野家,千葉県,吉野家 16号線五井店,千葉県市原市白金町4丁目8,1050,20230225,1030,20
吉野家,埼玉県,吉野家 16号線庄和町店,埼玉県春日部市西金野井303‐1,1050,20230225,1000,50
吉野家,千葉県,吉野家 16号線袖ケ浦店,千葉県袖ケ浦市神納1丁目20‐2,1050,20230225,1030,20
吉野家,埼玉県,吉野家 16号線東大宮店,埼玉県さいたま市見沼区深作3丁目4‐9,1100,20230225,1050,50
吉野家,埼玉県,吉野家 16号線入間扇町屋店,埼玉県入間市扇町屋5丁目4‐18,1050,20230225,1000,50
吉野家,大阪府,吉野家 170号線河内長野店,大阪府河内長野市上原西町10‐7,1080,20230225,1030,50
吉野家,大阪府,吉野家 170号線尺度店,大阪府羽曳野市尺度190‐1,1080,20230225,1030,50
吉野家,大阪府,吉野家 170号線藤井寺店,大阪府藤井寺市野中2丁目1‐1,1080,20230225,1030,50
吉野家,大阪府,吉野家 170号線八尾店,大阪府八尾市大竹1丁目62,1080,20230225,1030,50
吉野家,大阪府,吉野家 170号線富田林店,大阪府富田林市昭和町1丁目4‐7,1080,20230225,1030,50
吉野家,大阪府,吉野家 170号線野崎店,大阪府大東市南津の辺町21‐38,1050,20230225,1030,20
吉野家,大阪府,吉野家 171号線小野原店,大阪府箕面市粟生新家4丁目113番1,1100,20230225,1050,50
吉野家,兵庫県,吉野家 171号線西宮若山町店,兵庫県西宮市若山町11‐12,1100,20230225,980,120
吉野家,京都府,吉野家 171号線大山崎店,京都府乙訓郡大山崎町大山崎鏡田45‐30,1050,20230225,970,80
吉野家,大阪府,吉野家 171号線箕面店,大阪府箕面市萱野4丁目2‐17,1100,20230225,1030,70
吉野家,兵庫県,吉野家 173号線川西多田店,兵庫県川西市平野2丁目5‐6,1030,20230225,1000,30
吉野家,兵庫県,吉野家 175号線玉津店,兵庫県神戸市西区平野町福中219‐1,1000,20230225,980,20
吉野家,兵庫県,吉野家 176号線三田店,兵庫県三田市三輪4丁目6‐6,1030,20230225,980,50
吉野家,兵庫県,吉野家 176号線宝塚店,兵庫県宝塚市安倉北2丁目19‐2,1030,20230225,980,50
吉野家,兵庫県,吉野家 178号線豊岡店,兵庫県豊岡市下陰535‐1,1030,20230225,1000,30
吉野家,埼玉県,吉野家 17号線宮原店,埼玉県さいたま市北区宮原町1丁目503‐1,1150,20230225,1050,100
吉野家,埼玉県,吉野家 17号線熊谷佐谷田店,埼玉県熊谷市佐谷田88‐1,1100,20230225,1050,50
吉野家,埼玉県,吉野家 17号線鴻巣店,埼玉県鴻巣市宮地1丁目8‐49,1100,20230225,1000,100
吉野家,埼玉県,吉野家 17号線上尾店,埼玉県上尾市久保77‐1,1100,20230225,1000,100
吉野家,埼玉県,吉野家 17号線深谷店,埼玉県深谷市国済寺503‐3,1100,20230225,1000,100
吉野家,埼玉県,吉野家 17号線本庄若泉店,埼玉県本庄市若泉1丁目9‐9,1050,20230225,1000,50
吉野家,埼玉県,吉野家 17号線与野店,埼玉県さいたま市中央区円阿弥6丁目3‐1,1150,20230225,1050,100
吉野家,埼玉県,吉野家 17号線与野本町店,埼玉県さいたま市中央区本町西4丁目15‐12,1150,20230225,1050,100
吉野家,長野県,吉野家 18号線上田国分店,長野県上田市国分1丁目962‐1,1000,20230225,960,40
吉野家,愛知県,吉野家 19号線春日井西店,愛知県春日井市浅山町1311‐4,1050,20230225,1000,50
吉野家,愛知県,吉野家 19号線新守山店,愛知県名古屋市守山区幸心2丁目103,1050,20230225,1000,50
吉野家,岐阜県,吉野家 19号線瑞浪店,岐阜県瑞浪市上平町4丁目86,1000,20230225,950,50
吉野家,京都府,吉野家 1号線久御山店,京都府久世郡久御山町田井新荒見69‐1,1100,20230225,1000,100
吉野家,滋賀県,吉野家 1号線甲賀水口店,滋賀県甲賀市水口町名坂818,1000,20230225,950,50
吉野家,京都府,吉野家 1号線山科店,京都府京都市山科区大塚森町11‐3,1000,20230225,970,30
吉野家,滋賀県,吉野家 1号線草津店,滋賀県草津市南笠東1丁目2‐23,1050,20230225,950,100
吉野家,愛知県,吉野家 1号線知立店,愛知県知立市中町花山51‐1,1050,20230225,1000,50
吉野家,三重県,吉野家 1号線富洲原店,三重県三重郡川越町豊田318‐1,1050,20230225,1000,50
吉野家,大阪府,吉野家 1号線枚方店,大阪府枚方市宮之阪4丁目28‐39,1050,20230225,1030,20
吉野家,愛知県,吉野家 1号線弥富店,愛知県弥富市鯏浦町中六130‐1,1050,20230225,1000,50
吉野家,福岡県,吉野家 200号線飯塚店,福岡県飯塚市小正40‐3,950,20230225,930,20
吉野家,福岡県,吉野家 201号線篠栗店,福岡県糟屋郡篠栗町和田372‐1,950,20230225,930,20
吉野家,福岡県,吉野家 202号線BP原店,福岡県福岡市早良区原4丁目25‐15,980,20230225,950,30
吉野家,岐阜県,吉野家 21号線鵜沼店,岐阜県各務原市鵜沼西町1丁目648,1000,20230225,950,50
吉野家,岐阜県,吉野家 21号線各務原店,岐阜県各務原市鵜沼三ツ池町2丁目151,1000,20230225,950,50
吉野家,岐阜県,吉野家 21号線大垣北店,岐阜県大垣市八島町83,1000,20230225,950,50
吉野家,北海道,吉野家 228号線北斗七重浜,北海道北斗市七重浜7丁目14‐18,1000,20230225,980,20
吉野家,愛知県,吉野家 22号線西春店,愛知県北名古屋市宇福寺天神234,1050,20230225,1000,50
吉野家,北海道,吉野家 230号線藻岩店,北海道札幌市南区南35条西10丁目13,1030,20230225,980,50
吉野家,北海道,吉野家 231号線篠路店,北海道札幌市北区篠路2条1丁目2‐8,1030,20230225,980,50
吉野家,三重県,吉野家 23号線伊勢店,三重県伊勢市御薗町長屋2127,1050,20230225,1000,50
吉野家,三重県,吉野家 23号線津南店,三重県津市高茶屋小森町441‐7,1050,20230225,1000,50
吉野家,三重県,吉野家 23号線白子店,三重県鈴鹿市白子駅前6‐39,1000,20230225,950,50
吉野家,奈良県,吉野家 24号線葛城店,奈良県葛城市忍海488‐1,1000,20230225,930,70
吉野家,和歌山,吉野家 24号線岩出店,和歌山県岩出市西野20‐6,1000,20230225,950,50
吉野家,和歌山,吉野家 24号線橋本高野口店,和歌山県橋本市高野口町伏原933‐1,1000,20230225,950,50
吉野家,京都府,吉野家 24号線竹田久保町店,京都府京都市伏見区竹田久保町68,1050,20230225,1000,50
吉野家,奈良県,吉野家 24号線奈良北店,奈良県奈良市法蓮町439‐1,1050,20230225,950,100
吉野家,兵庫県,吉野家 250号線加古川備後店,兵庫県加古川市加古川町南備後13‐1,1100,20230225,980,120
吉野家,兵庫県,吉野家 250号線西明石店,兵庫県明石市西明石西町1丁目10‐12,1000,20230225,980,20
吉野家,兵庫県,吉野家 250号線播磨町店,兵庫県加古郡播磨町北古田1丁目19‐2,1000,20230225,980,20
吉野家,埼玉県,吉野家 254号線新座店,埼玉県新座市野火止1丁目7‐20,1100,20230225,1000,100
吉野家,埼玉県,吉野家 254号線川越木野目店,埼玉県川越市木野目446‐1,1050,20230225,1000,50
吉野家,三重県,吉野家 258号線桑名店,三重県桑名市江場676‐1,1050,20230225,1000,50
吉野家,奈良県,吉野家 25号線天理店,奈良県天理市田井庄町498‐1,1000,20230225,930,70
吉野家,奈良県,吉野家 25号線斑鳩店,奈良県生駒郡斑鳩町幸前2丁目309‐3,1000,20230225,930,70
吉野家,大阪府,吉野家 26号線貝塚店,大阪府貝塚市石才229‐1,1080,20230225,1030,50
吉野家,大阪府,吉野家 26号線岸和田八阪店,大阪府岸和田市八阪町1丁目7‐13,1080,20230225,1030,50
吉野家,大阪府,吉野家 26号線堺浜寺店,大阪府堺市西区浜寺船尾町東1丁112,1080,20230225,1030,50
吉野家,大阪府,吉野家 26号線泉佐野店,大阪府泉佐野市高松東2丁目6529,1080,20230225,1030,50
吉野家,大阪府,吉野家 26号線泉大津店,大阪府泉大津市北豊中町3丁目1‐3,1080,20230225,1030,50
吉野家,京都府,吉野家 27号線西舞鶴店,京都府舞鶴市円満寺137‐3,1050,20230225,1000,50
吉野家,福井県,吉野家 27号線敦賀店,福井県敦賀市古田刈12‐1‐1,1100,20230225,1050,50
吉野家,山形県,吉野家 286号線山形南店,山形県山形市南原町2丁目8‐3,950,20230225,900,50
吉野家,兵庫県,吉野家 28号線洲本店,兵庫県南あわじ市山添81‐1,1000,20230225,980,20
吉野家,茨城県,吉野家 294号線下館店,茨城県筑西市西谷貝330,1050,20230225,980,70
吉野家,山口県,吉野家 2号線下関長府店,山口県下関市長府才川1丁目42‐41,980,20230225,950,30
吉野家,兵庫県,吉野家 2号線姫路市川橋店,兵庫県姫路市花田町一本松437‐3,1030,20230225,980,50
吉野家,広島県,吉野家 2号線福山久松通り店,広島県福山市延広町4‐15,1000,20230225,950,50
吉野家,兵庫県,吉野家 2号線明石大久保店,兵庫県明石市大久保町駅前1丁目17‐17,1100,20230225,980,120
吉野家,大阪府,吉野家 308号線吉田店,大阪府東大阪市角田1丁目5‐50,1100,20230225,1030,70
吉野家,大阪府,吉野家 309号線三宅店,大阪府松原市三宅中1丁目269‐2,1080,20230225,1030,50
吉野家,大阪府,吉野家 309号線美原店,大阪府堺市美原区太井81‐1,1080,20230225,1030,50
吉野家,高知県,吉野家 32号線高知高須東店,高知県高知市高須東町1‐3,980,20230225,950,30
吉野家,青森県,吉野家 339号線五所川原店,青森県五所川原市烏森502,900,20230225,870,30
吉野家,茨城県,吉野家 349号線那珂菅谷店,茨城県那珂市竹ノ内1‐5‐16,980,20230225,930,50
吉野家,群馬県,吉野家 354号線館林店,群馬県館林市富士原町943‐1,960,20230225,950,10
吉野家,埼玉県,吉野家 407号線妻沼店,埼玉県熊谷市妻沼1780‐1,1100,20230225,1000,100
吉野家,埼玉県,吉野家 407号線鶴ヶ島店,埼玉県鶴ヶ島市脚折町5丁目16‐1,1050,20230225,1000,50
吉野家,愛知県,吉野家 41号線小牧店,愛知県小牧市小木東1丁目140,1050,20230225,1000,50
吉野家,和歌山,吉野家 42号線和歌山紀三井寺店,和歌山県和歌山市紀三井寺541‐1,1000,20230225,950,50
吉野家,青森県,吉野家 45号線八戸類家店,青森県八戸市類家4丁目1‐2,950,20230225,900,50
吉野家,埼玉県,吉野家 463号線BP和ヶ原店,埼玉県所沢市和ヶ原2丁目216‐1,1050,20230225,1000,50
吉野家,埼玉県,吉野家 463号線南与野店,埼玉県さいたま市中央区鈴谷2丁目603‐2,1100,20230225,1050,50
吉野家,福島県,吉野家 49号線郡山安積店,福島県郡山市安積町日出山2丁目154‐1,930,20230225,900,30
吉野家,福島県,吉野家 49号線郡山桑野店,福島県郡山市桑野町4‐47‐1,930,20230225,900,30
吉野家,宮城県,吉野家 4号線岩沼店,宮城県岩沼市末広1丁目241‐1,950,20230225,930,20
吉野家,埼玉県,吉野家 4号線春日部緑町店,埼玉県春日部市緑町6丁目15‐3,1050,20230225,1000,50
吉野家,栃木県,吉野家 4号線小山本郷店,栃木県小山市本郷町1丁目3‐20,1000,20230225,950,50
吉野家,福島県,吉野家 4号線新白河店,福島県西白河郡西郷村豊作西18‐1,1030,20230225,1000,30
吉野家,福島県,吉野家 4号線須賀川店,福島県須賀川市大黒町135‐1,1030,20230225,1000,30
吉野家,埼玉県,吉野家 4号線杉戸高野台店,埼玉県幸手市上高野2070‐1,1050,20230225,1000,50
吉野家,宮城県,吉野家 4号線大河原店,宮城県柴田郡大河原町新東20‐5,930,20230225,900,30
吉野家,宮城県,吉野家 4号線白石店,宮城県白石市福岡蔵本西町78,930,20230225,900,30
吉野家,福島県,吉野家 4号線本宮店,福島県本宮市本宮栄田68‐1,930,20230225,900,30
吉野家,栃木県,吉野家 4号線矢板店,栃木県矢板市中930‐1,960,20230225,930,30
吉野家,鳥取県,吉野家 53号線鳥取吉成店,鳥取県鳥取市吉成779‐2,950,20230225,900,50
吉野家,東京都,吉野家 6号線白鳥店,東京都葛飾区白鳥2丁目21‐24,1200,20230225,1150,50
吉野家,石川県,吉野家 8号線金沢西インター店,石川県金沢市森戸2丁目196,1000,20230225,950,50
吉野家,滋賀県,吉野家 8号線栗東店,滋賀県栗東市出庭542,1100,20230225,950,150
吉野家,新潟県,吉野家 8号線黒埼店,新潟県新潟市西区山田662,980,20230225,950,30
吉野家,石川県,吉野家 8号線松任店,石川県白山市田中町204‐1,1000,20230225,950,50
吉野家,新潟県,吉野家 8号線長岡寺島店,新潟県長岡市寺島町307‐1,980,20230225,950,30
吉野家,滋賀県,吉野家 8号線彦根店,滋賀県彦根市東沼波町138‐1,1050,20230225,1000,50
吉野家,滋賀県,吉野家 8号線野洲店,滋賀県野洲市小篠原481‐1,1000,20230225,950,50
吉野家,京都府,吉野家 9号線亀岡千代川店,京都府亀岡市千代川町高野林西田7‐27,1050,20230225,1000,50
吉野家,京都府,吉野家 9号線福知山店,京都府福知山市駅南町3丁目61‐1,1050,20230225,1000,50
吉野家,京都府,吉野家 9号線洛西中山店,京都府京都市西京区大枝中山町1‐124,1000,20230225,970,30
吉野家,栃木県,吉野家 Dila小山店,栃木県小山市城山町3丁目3‐22,1000,20230225,950,50
吉野家,兵庫県,吉野家 JR神戸駅店,兵庫県神戸市中央区相生町3丁目1,1300,20230225,1100,200
吉野家,大阪府,吉野家 JR西九条駅店,大阪府大阪市此花区西九条1丁目32‐16,1100,20230225,1030,70
吉野家,大阪府,吉野家 JR塚本駅店,大阪府大阪市淀川区塚本2丁目28‐2,1300,20230225,1030,270
吉野家,兵庫県,吉野家 JR姫路駅店,兵庫県姫路市駅前町188,1100,20230225,1000,100
吉野家,兵庫県,吉野家 JR兵庫駅店,兵庫県神戸市兵庫区駅南通5丁目3‐7,1200,20230225,1050,150
吉野家,大阪府,吉野家 ぐみの木店,大阪府大阪狭山市ぐみの木6丁目921‐1,1080,20230225,1030,50
吉野家,埼玉県,吉野家 さいたま東大宮店,埼玉県さいたま市見沼区東大宮3丁目3‐12,1100,20230225,1050,50
吉野家,埼玉県,吉野家 せんげん台駅西口店,埼玉県越谷市千間台西1丁目67,1050,20230225,1000,50
吉野家,茨城県,吉野家 つくば台町店,茨城県つくば市台町2丁目3‐14,1000,20230225,950,50
吉野家,茨城県,吉野家 つくば大境店,茨城県つくば市西大橋593‐10,1000,20230225,950,50
吉野家,大阪府,吉野家 なんばCITY南館店,大阪府大阪市中央区難波5丁目1‐60,1150,20230225,1100,50
吉野家,茨城県,吉野家 ひたちなか西光地店,茨城県ひたちなか市西光地3丁目1‐1,980,20230225,930,50
吉野家,茨城県,吉野家 ひたちなか店,茨城県ひたちなか市中根3169‐2,980,20230225,950,30
吉野家,群馬県,吉野家 みどり大間々店,群馬県みどり市大間々町大間々382‐1,980,20230225,950,30
吉野家,岐阜県,吉野家 アスティ岐阜駅店,岐阜県岐阜市橋本町1丁目10‐1,1000,20230225,950,50
吉野家,埼玉県,吉野家 イオンモール川口前川店,埼玉県川口市前川1丁目1‐11,1130,20230225,1100,30
吉野家,大阪府,吉野家 エコールいずみ店,大阪府和泉市いぶき野5丁目1‐14,1080,20230225,1030,50
吉野家,千葉県,吉野家 カインズホーム市原店,千葉県市原市更級3丁目1‐1,1050,20230225,1030,20
吉野家,栃木県,吉野家 カインズ宇都宮テクノ店,栃木県宇都宮市ゆいの杜5丁目26‐5,1030,20230225,1000,30
吉野家,埼玉県,吉野家 カインズ羽生店,埼玉県羽生市小松457‐1,1050,20230225,1000,50
吉野家,茨城県,吉野家 カインズ結城店,茨城県結城市結城9784‐3,1000,20230225,980,20
吉野家,大阪府,吉野家 ザビエル公園店,大阪府堺市堺区戎之町東1‐1,1080,20230225,1030,50
吉野家,神奈川,吉野家 センター南駅店,神奈川県横浜市都筑区茅ヶ崎中央1‐1,1200,20230225,1150,50
吉野家,大阪府,吉野家 ビエラ岸辺健都店,大阪府吹田市岸部新町5‐45,1100,20230225,1030,70
吉野家,大阪府,吉野家 ビエラ高槻南店,大阪府高槻市紺屋町1‐3,1100,20230225,1030,70
吉野家,新潟県,吉野家 フレスポ新発田店,新潟県新発田市富塚町3丁目281‐1,960,20230225,930,30
吉野家,兵庫県,吉野家 プリコ三宮店,兵庫県神戸市中央区加納町4丁目1‐1,1100,20230225,1050,50
吉野家,大阪府,吉野家 ヴィアあべのウォーク店,大阪府大阪市阿倍野区阿倍野筋1丁目6‐1,1150,20230225,1030,120
吉野家,北海道,吉野家 旭川4条通店,北海道旭川市4条通2丁目924‐2,1000,20230225,980,20
吉野家,北海道,吉野家 旭川永山店,北海道旭川市永山3条8丁目1‐5,1000,20230225,980,20
吉野家,北海道,吉野家 旭川豊岡店,北海道旭川市豊岡1条4丁目340‐43,1000,20230225,980,20
吉野家,三重県,吉野家 伊賀上野店,三重県伊賀市小田町251番地,1050,20230225,1000,50
吉野家,愛知県,吉野家 一宮妙興寺店,愛知県一宮市妙興寺1丁目2‐10,1050,20230225,1000,50
吉野家,愛知県,吉野家 稲沢下津店,愛知県稲沢市下津下町西1丁目62‐1,1050,20230225,1000,50
吉野家,愛知県,吉野家 稲沢市役所前店,愛知県稲沢市船橋町花ノ木1191‐1,1050,20230225,1000,50
吉野家,大阪府,吉野家 茨田店,大阪府大阪市鶴見区浜3丁目7‐107,1100,20230225,1030,70
吉野家,京都府,吉野家 宇治槙島店,京都府宇治市槙島町一の坪39,1000,20230225,970,30
吉野家,栃木県,吉野家 宇都宮宮の内店,栃木県宇都宮市宮の内3丁目177‐1,1030,20230225,1000,30
吉野家,栃木県,吉野家 宇都宮競輪場通り店,栃木県宇都宮市上大曽町361‐1,1030,20230225,1000,30
吉野家,栃木県,吉野家 宇都宮今泉店,栃木県宇都宮市中今泉5丁目37‐4,1000,20230225,980,20
吉野家,栃木県,吉野家 宇都宮細谷町店,栃木県宇都宮市細谷町326,1040,20230225,1000,40
吉野家,栃木県,吉野家 宇都宮城東店,栃木県宇都宮市城東1丁目10‐26,1040,20230225,1000,40
吉野家,栃木県,吉野家 宇都宮南店,栃木県宇都宮市西川田町936‐6,1040,20230225,1000,40
吉野家,大阪府,吉野家 羽曳野店,大阪府羽曳野市向野3丁目74‐1,1080,20230225,1030,50
吉野家,愛知県,吉野家 栄生店,愛知県名古屋市西区栄生1丁目32‐16,1100,20230225,1050,50
吉野家,埼玉県,吉野家 越谷駅高架下店,埼玉県越谷市弥生町4‐11,1050,20230225,1000,50
吉野家,京都府,吉野家 円町店,京都府京都市中京区西ノ京円町6‐1,1100,20230225,1000,100
吉野家,新潟県,吉野家 燕三条店,新潟県三条市上須頃323,980,20230225,950,30
吉野家,長野県,吉野家 塩尻店,長野県塩尻市広丘高出1783‐1,1000,20230225,960,40
吉野家,奈良県,吉野家 王寺駅前店,奈良県北葛城郡王寺町久度2丁目3538‐1,1000,20230225,930,70
吉野家,岡山県,吉野家 岡山新保店,岡山県岡山市南区新保1614‐1,1000,20230225,950,50
吉野家,岡山県,吉野家 岡山大安寺店,岡山県岡山市北区大安寺南町1丁目6‐1,1000,20230225,950,50
吉野家,東京都,吉野家 荻窪北口店,東京都杉並区上荻1丁目15‐2,1200,20230225,1150,50
吉野家,埼玉県,吉野家 桶川北店,埼玉県桶川市北2丁目1538‐4,1050,20230225,1000,50
吉野家,山口県,吉野家 下関幡生店,山口県下関市生野町2丁目28‐4,980,20230225,950,30
吉野家,東京都,吉野家 下北沢駅東口店,東京都世田谷区北沢2丁目25‐16,1250,20230225,1200,50
吉野家,兵庫県,吉野家 加古川駅北口店,兵庫県加古川市加古川町篠原町30‐10,1000,20230225,980,20
吉野家,奈良県,吉野家 河合町店,奈良県北葛城郡河合町池部2丁目4‐17,1000,20230225,930,70
吉野家,大阪府,吉野家 河内小阪駅前店,大阪府東大阪市小阪本町1丁目3‐2,1080,20230225,1030,50
吉野家,埼玉県,吉野家 外環和光北インター通り店,埼玉県朝霞市台久田257‐1,1150,20230225,1100,50
吉野家,奈良県,吉野家 橿原木原町店,奈良県橿原市木原町223‐1,1000,20230225,930,70
吉野家,東京都,吉野家 蒲田駅前店,東京都大田区西蒲田7丁目5‐12,1180,20230225,1150,30
吉野家,東京都,吉野家 蒲田東口店,東京都大田区蒲田5丁目24‐3,1180,20230225,1150,30
吉野家,東京都,吉野家 環状7号線豊玉南店,東京都練馬区豊玉南2丁目16‐15,1200,20230225,1100,100
吉野家,北海道,吉野家 環状通東店,北海道札幌市東区北15条東17丁目1,1030,20230225,980,50
吉野家,大阪府,吉野家 関目店,大阪府大阪市城東区成育5丁目22‐11,1100,20230225,1030,70
吉野家,大阪府,吉野家 岸和田和泉インター店,大阪府岸和田市三田町400‐21,1080,20230225,1030,50
吉野家,三重県,吉野家 亀山店,三重県亀山市東御幸町穴淵224‐2,1050,20230225,1000,50
吉野家,東京都,吉野家 吉祥寺北店,東京都武蔵野市吉祥寺本町1丁目8‐3,1200,20230225,1150,50
吉野家,埼玉県,吉野家 久喜店,埼玉県久喜市久喜本785‐1,1100,20230225,1050,50
吉野家,京都府,吉野家 京都駅八条口店,京都府京都市南区西九条北ノ内町41‐4,1100,20230225,1050,50
吉野家,京都府,吉野家 京都競馬場店,京都府京都市伏見区葭島渡場町32京都競馬場内1F,1000,20230225,970,30
吉野家,京都府,吉野家 京都九条店,京都府京都市南区西九条東島町61,1070,20230225,1000,70
吉野家,京都府,吉野家 京都洛北店,京都府京都市左京区下鴨本町12‐3,1100,20230225,1000,100
吉野家,埼玉県,吉野家 狭山台店,埼玉県狭山市狭山台1丁目2‐5,1050,20230225,1000,50
吉野家,兵庫県,吉野家 玉江橋線塚口店,兵庫県尼崎市塚口本町3丁目380‐9,1030,20230225,1000,30
吉野家,大阪府,吉野家 玉出店,大阪府大阪市住之江区粉浜西1丁目1‐23,1080,20230225,1030,50
吉野家,滋賀県,吉野家 近江八幡店,滋賀県近江八幡市鷹飼町1478,1050,20230225,1000,50
吉野家,大阪府,吉野家 近鉄八尾駅前店,大阪府八尾市光町2丁目180‐1,1080,20230225,1030,50
吉野家,石川県,吉野家 金沢もりの里店,石川県金沢市もりの里1丁目60,1000,20230225,950,50
吉野家,石川県,吉野家 金沢三馬店,石川県金沢市三馬3‐345,1000,20230225,950,50
吉野家,北海道,吉野家 釧路鳥取大通店,北海道釧路市鳥取大通7丁目6‐1,1000,20230225,980,20
吉野家,埼玉県,吉野家 熊谷駅北口店,埼玉県熊谷市筑波2丁目112,1100,20230225,1050,50
吉野家,熊本県,吉野家 熊本下通店,熊本県熊本市中央区下通1丁目3‐1,980,20230225,950,30
吉野家,福島県,吉野家 郡山さくら通り店,福島県郡山市虎丸町9‐15,930,20230225,900,30
吉野家,大阪府,吉野家 恵美須町店,大阪府大阪市浪速区日本橋5丁目13‐9,1100,20230225,1030,70
吉野家,埼玉県,吉野家 見沼南中野店,埼玉県さいたま市見沼区南中野461‐1,1100,20230225,1050,50
吉野家,千葉県,吉野家 古市場店,千葉県千葉市緑区古市場町624‐1,1050,20230225,1030,20
吉野家,滋賀県,吉野家 湖南夏見店,滋賀県湖南市夏見425‐1,1000,20230225,950,50
吉野家,大阪府,吉野家 御堂筋難波店,大阪府大阪市中央区道頓堀2丁目1‐1,1200,20230225,1150,50
吉野家,和歌山,吉野家 御坊店,和歌山県御坊市薗307‐1,1000,20230225,950,50
吉野家,青森県,吉野家 弘前中央通り店,青森県弘前市北瓦ヶ町7‐1,900,20230225,870,30
吉野家,東京都,吉野家 江古田南口店,東京都練馬区豊玉上1丁目10‐10,1200,20230225,1100,100
吉野家,大阪府,吉野家 江坂駅東店,大阪府吹田市江坂町1丁目22‐12,1100,20230225,1030,70
吉野家,福岡県,吉野家 港町店,福岡県福岡市中央区港2丁目7‐7,1050,20230225,1000,50
吉野家,東京都,吉野家 甲州街道府中白糸台店,東京都府中市若松町1丁目25‐6,1150,20230225,1100,50
吉野家,東京都,吉野家 高円寺駅前店,東京都杉並区高円寺北2丁目4‐7,1200,20230225,1150,50
吉野家,群馬県,吉野家 高崎環状線上豊岡店,群馬県高崎市上豊岡町833‐1,1000,20230225,950,50
吉野家,東京都,吉野家 高島平大門店,東京都板橋区高島平3丁目3‐2,1150,20230225,1100,50
吉野家,大阪府,吉野家 鴻池新田店,大阪府東大阪市中鴻池町2丁目1‐7,1050,20230225,1030,20
吉野家,愛知県,吉野家 国際センター店,愛知県名古屋市中村区那古野1丁目46‐12,1100,20230225,1050,50
吉野家,東京都,吉野家 国分寺北口店,東京都国分寺市本町2丁目10‐5,1150,20230225,1100,50
吉野家,大阪府,吉野家 今里店,大阪府大阪市東成区大今里西1丁目30‐10,1080,20230225,1030,50
吉野家,東京都,吉野家 根津店,東京都文京区根津2丁目18‐12,1200,20230225,1100,100
吉野家,新潟県,吉野家 佐渡佐和田店,新潟県佐渡市長木767‐1,930,20230225,900,30
吉野家,山口県,吉野家 佐波川SA下り店,山口県防府市佐野452‐2,980,20230225,950,30
吉野家,山口県,吉野家 佐波川SA上り店,山口県防府市佐野1431,980,20230225,950,30
吉野家,埼玉県,吉野家 坂戸鎌倉店,埼玉県坂戸市鎌倉町1‐1,1050,20230225,1000,50
吉野家,大阪府,吉野家 阪急茨木市駅前店,大阪府茨木市別院町3‐1,1100,20230225,1030,70
吉野家,大阪府,吉野家 阪南鳥取店,大阪府阪南市黒田705‐1,1080,20230225,1030,50
吉野家,大阪府,吉野家 堺インター店,大阪府堺市中区平井775‐1,1080,20230225,1030,50
吉野家,大阪府,吉野家 堺石津川店,大阪府堺市西区浜寺石津町西2丁322‐1,1100,20230225,1030,70
吉野家,大阪府,吉野家 堺東駅前店,大阪府堺市堺区中瓦町2丁目3‐26,1080,20230225,1030,50
吉野家,北海道,吉野家 札幌エスタ店,北海道札幌市中央区北5条西2丁目1,1030,20230225,980,50
吉野家,北海道,吉野家 札幌駅APIA店,北海道札幌市中央区北5条西4丁目,1030,20230225,980,50
吉野家,北海道,吉野家 札幌西町店,北海道札幌市西区西町南11丁目1‐38,1030,20230225,980,50
吉野家,北海道,吉野家 札幌狸小路店,北海道札幌市中央区南3条西4丁目12‐1,1100,20230225,1000,100
吉野家,北海道,吉野家 札幌伏古店,北海道札幌市東区伏古11条4丁目1‐5,1030,20230225,980,50
吉野家,北海道,吉野家 札幌麻生店,北海道札幌市北区北40条西5丁目331‐1,1030,20230225,980,50
吉野家,東京都,吉野家 雑色店,東京都大田区仲六郷2丁目42‐3,1180,20230225,1150,30
吉野家,兵庫県,吉野家 三宮駅東店,兵庫県神戸市中央区旭通5丁目3‐15,1200,20230225,1050,150
吉野家,東京都,吉野家 三鷹駅南口店,東京都三鷹市下連雀3丁目27‐9,1200,20230225,1150,50
吉野家,青森県,吉野家 三沢松園町店,青森県三沢市松園町3丁目1‐32,950,20230225,920,30
吉野家,山形県,吉野家 山形西バイパス店,山形県山形市西田2丁目24‐1,950,20230225,900,50
吉野家,山口県,吉野家 山陽小野田店,山口県山陽小野田市日の出2丁目8‐5,980,20230225,950,30
吉野家,広島県,吉野家 山陽道沼田PA下り店,広島県広島市安佐南区伴東町136‐1,1000,20230225,950,50
吉野家,埼玉県,吉野家 産業道路さいたま上木崎店,埼玉県さいたま市浦和区上木崎4丁目12‐12,1100,20230225,1050,50
吉野家,東京都,吉野家 市ヶ谷駅前店,東京都千代田区五番町3‐3,1200,20230225,1150,50
吉野家,東京都,吉野家 志村坂上店,東京都板橋区志村2‐1‐4,1150,20230225,1100,50
吉野家,埼玉県,吉野家 志木南口店,埼玉県新座市東北2丁目38‐1,1100,20230225,1000,100
吉野家,大阪府,吉野家 寺田町駅前店,大阪府大阪市天王寺区大道4丁目10‐9,1100,20230225,1030,70
吉野家,鹿児島,吉野家 鹿屋店,鹿児島県鹿屋市寿2丁目8‐7,950,20230225,930,20
吉野家,大阪府,吉野家 芝田町店,大阪府大阪市北区芝田町2丁目1‐21,1170,20230225,1100,70
吉野家,愛知県,吉野家 守山店,愛知県名古屋市守山区大谷町1‐43,1100,20230225,1050,50
吉野家,北海道,吉野家 手稲前田店,北海道札幌市手稲区前田5条6丁目3‐18,1030,20230225,980,50
吉野家,大阪府,吉野家 住之江公園店,大阪府大阪市住之江区南加賀屋2丁目8‐26,1080,20230225,1030,50
吉野家,福岡県,吉野家 春吉店,福岡県福岡市中央区春吉3丁目21‐21,1000,20230225,950,50
吉野家,愛知県,吉野家 春日井出川町店,愛知県春日井市出川町8丁目10‐6,1050,20230225,1000,50
吉野家,愛知県,吉野家 春日井店,愛知県春日井市鳥居松町1丁目15‐297,1050,20230225,1000,50
吉野家,東京都,吉野家 初台店,東京都渋谷区代々木4丁目32‐3,1250,20230225,1200,50
吉野家,埼玉県,吉野家 所沢駅前店,埼玉県所沢市日吉町11‐20,1100,20230225,1050,50
吉野家,新潟県,吉野家 女池上山店,新潟県新潟市中央区女池上山2丁目17‐6,980,20230225,950,30
吉野家,愛知県,吉野家 小割通店,愛知県名古屋市港区小割通3丁目1,1050,20230225,1000,50
吉野家,福岡県,吉野家 小倉京町店,福岡県北九州市小倉北区京町2丁目6‐18,1000,20230225,950,50
吉野家,福岡県,吉野家 小倉中井店,福岡県北九州市小倉北区中井2丁目7‐21,1000,20230225,950,50
吉野家,東京都,吉野家 小田急町田駅南口店,東京都町田市原町田6丁目11‐7,1150,20230225,1100,50
吉野家,神奈川,吉野家 小田急登戸駅店,神奈川県川崎市多摩区登戸3437‐2,1150,20230225,1100,50
吉野家,愛知県,吉野家 小牧岩崎店,愛知県小牧市岩崎5丁目195,1050,20230225,1000,50
吉野家,愛知県,吉野家 庄内緑地公園店,愛知県名古屋市西区南川町15,1050,20230225,1000,50
吉野家,京都府,吉野家 松井山手店,京都府八幡市美濃山出口38‐1,1050,20230225,1000,50
吉野家,三重県,吉野家 松阪久保町店,三重県松阪市久保町1843‐46,1050,20230225,1000,50
吉野家,三重県,吉野家 松阪朝日町店,三重県松阪市朝日町一区10-15,1050,20230225,1000,50
吉野家,新潟県,吉野家 上越高田店,新潟県上越市木田3丁目5‐17,980,20230225,950,30
吉野家,愛知県,吉野家 上前津店,愛知県名古屋市中区大須4丁目11‐44,1050,20230225,1000,50
吉野家,埼玉県,吉野家 上尾駅前店,埼玉県上尾市谷津2丁目1‐50‐1,1100,20230225,1000,100
吉野家,大阪府,吉野家 上本町店,大阪府大阪市天王寺区上本町6丁目6‐23,1100,20230225,1030,70
吉野家,大阪府,吉野家 寝屋川昭栄町店,大阪府寝屋川市昭栄町16‐8,1050,20230225,1030,20
吉野家,栃木県,吉野家 新4号線上三川店,栃木県河内郡上三川町しらさぎ1丁目6‐8,1030,20230225,1000,30
吉野家,兵庫県,吉野家 新開地店,兵庫県神戸市兵庫区新開地2丁目1‐9,1100,20230225,1050,50
吉野家,新潟県,吉野家 新潟海老ケ瀬IC店,新潟県新潟市東区大形本町5丁目16‐6,980,20230225,950,30
吉野家,新潟県,吉野家 新潟競馬場店,新潟県新潟市北区笹山3490,980,20230225,950,30
吉野家,北海道,吉野家 新琴似4番通店,北海道札幌市北区新琴似八条17丁目765‐3,1030,20230225,980,50
吉野家,東京都,吉野家 新宿センタービル店,東京都新宿区西新宿1丁目25‐1,1250,20230225,1200,50
吉野家,東京都,吉野家 新宿一丁目店,東京都新宿区新宿1丁目33‐10,1250,20230225,1200,50
吉野家,埼玉県,吉野家 新所沢店,埼玉県所沢市けやき台1丁目13‐6,1050,20230225,1000,50
吉野家,兵庫県,吉野家 神戸伊川谷店,兵庫県神戸市西区伊川谷町潤和1155‐1,1030,20230225,980,50
吉野家,兵庫県,吉野家 神戸名谷インター店,兵庫県神戸市垂水区名谷町997‐4,1080,20230225,1030,50
吉野家,愛知県,吉野家 甚目寺店,愛知県あま市下萱津五反田57,1050,20230225,1000,50
吉野家,兵庫県,吉野家 須磨パティオ店,兵庫県神戸市須磨区中落合2丁目2‐1,1030,20230225,980,50
吉野家,大阪府,吉野家 吹田山田店,大阪府吹田市山田西2丁目7‐14,1100,20230225,1030,70
吉野家,岐阜県,吉野家 瑞穂店,岐阜県瑞穂市馬場小城町1丁目23,1000,20230225,950,50
吉野家,静岡県,吉野家 清水大坪店,静岡県静岡市清水区大坪1丁目9‐11,1000,20230225,950,50
吉野家,東京都,吉野家 聖蹟桜ヶ丘店,東京都多摩市関戸2丁目41‐1,1150,20230225,1100,50
吉野家,東京都,吉野家 西荻窪駅前店,東京都杉並区西荻北3丁目19‐3,1200,20230225,1150,50
吉野家,兵庫県,吉野家 西宮山口町店,兵庫県西宮市山口町名来2丁目19,1030,20230225,980,50
吉野家,愛知県,吉野家 西大須店,愛知県名古屋市中区大須2丁目27‐40,1050,20230225,1000,50
吉野家,大阪府,吉野家 西中島南方駅前店,大阪府大阪市淀川区西中島3丁目20‐9,1200,20230225,1030,170
吉野家,大阪府,吉野家 西田辺店,大阪府大阪市阿倍野区西田辺町1丁目17‐1,1080,20230225,1030,50
吉野家,東京都,吉野家 青山一丁目店,東京都港区北青山1丁目3‐3,1250,20230225,1200,50
吉野家,静岡県,吉野家 静岡瀬名川店,静岡県静岡市葵区瀬名川2丁目4‐10,1000,20230225,950,50
吉野家,東京都,吉野家 赤羽東口店,東京都北区赤羽1丁目10‐2,1200,20230225,1150,50
吉野家,東京都,吉野家 雪が谷大塚駅前店,東京都大田区南雪谷2丁目17‐14,1180,20230225,1150,30
吉野家,宮城県,吉野家 仙台河原町店,宮城県仙台市若林区河原町1丁目1‐27,950,20230225,930,20
吉野家,宮城県,吉野家 仙台長町南店,宮城県仙台市太白区長町8丁目21‐6,950,20230225,930,20
吉野家,愛知県,吉野家 千音寺店,愛知県名古屋市中川区吉津1丁目1808,1050,20230225,1000,50
吉野家,大阪府,吉野家 千日前店,大阪府大阪市中央区難波千日前12‐41,1150,20230225,1100,50
吉野家,千葉県,吉野家 千葉さつきが丘店,千葉県千葉市花見川区犢橋町1102‐3,1050,20230225,1000,50
吉野家,千葉県,吉野家 千葉中央店,千葉県千葉市中央区富士見2丁目22‐15,1100,20230225,1050,50
吉野家,千葉県,吉野家 千葉末広街道店,千葉県千葉市中央区末広3丁目17‐1,1050,20230225,1030,20
吉野家,東京都,吉野家 川越街道成増店,東京都板橋区成増1丁目28‐14,1150,20230225,1100,50
吉野家,埼玉県,吉野家 川越的場店,埼玉県川越市的場801‐1,1050,20230225,1000,50
吉野家,埼玉県,吉野家 川口駅東口店,埼玉県川口市川口1丁目1‐1,1200,20230225,1100,100
吉野家,埼玉県,吉野家 川口芝店,埼玉県川口市芝3丁目19‐4,1130,20230225,1100,30
吉野家,埼玉県,吉野家 川口上青木店,埼玉県川口市上青木1丁目5‐6,1100,20230225,1050,50
吉野家,埼玉県,吉野家 川口柳崎店,埼玉県川口市柳崎3丁目9‐2,1100,20230225,1050,50
吉野家,兵庫県,吉野家 川西店,兵庫県川西市下加茂1丁目472‐1,1030,20230225,1000,30
吉野家,大阪府,吉野家 船場中央店,大阪府大阪市中央区南本町2丁目6‐8,1150,20230225,1100,50
吉野家,福岡県,吉野家 早良街道西新店,福岡県福岡市早良区曙1丁目13‐25,980,20230225,950,30
吉野家,埼玉県,吉野家 草加新栄店,埼玉県草加市新栄1丁目57‐10,1100,20230225,1050,50
吉野家,埼玉県,吉野家 草加新田店,埼玉県草加市旭町1丁目4‐36,1100,20230225,1050,50
吉野家,東京都,吉野家 蔵前橋通鳥越店,東京都台東区台東1丁目38‐7,1180,20230225,1100,80
吉野家,滋賀県,吉野家 多賀SA下り店,滋賀県犬上郡多賀町敏満寺西66‐31,1100,20230225,1000,100
吉野家,大阪府,吉野家 太子堂店,大阪府八尾市南太子堂2丁目1‐59,1080,20230225,1030,50
吉野家,奈良県,吉野家 大安寺店,奈良県奈良市南京終町3丁目1530‐12,980,20230225,930,50
吉野家,東京都,吉野家 大井町西口店,東京都品川区大井1丁目1‐16,1200,20230225,1150,50
吉野家,京都府,吉野家 大久保バイパス城陽店,京都府城陽市寺田塚本205,1100,20230225,1000,100
吉野家,埼玉県,吉野家 大宮西口店,埼玉県さいたま市大宮区桜木町1丁目1‐11,1200,20230225,1100,100
吉野家,奈良県,吉野家 大宮通り芝辻町店,奈良県奈良市芝辻町1丁目3‐23,980,20230225,930,50
吉野家,埼玉県,吉野家 大宮店,埼玉県さいたま市大宮区仲町1丁目97,1200,20230225,1100,100
吉野家,埼玉県,吉野家 大宮東口店,埼玉県さいたま市大宮区大門町1丁目17‐1,1200,20230225,1100,100
吉野家,福岡県,吉野家 大橋店,福岡県福岡市南区大橋1丁目19‐22,980,20230225,950,30
吉野家,大阪府,吉野家 大国町店,大阪府大阪市浪速区敷津東2丁目5‐11,1100,20230225,1030,70
吉野家,東京都,吉野家 大山駅前店,東京都板橋区大山町4‐6,1150,20230225,1100,50
吉野家,東京都,吉野家 大森店,東京都大田区大森北1丁目7‐6,1180,20230225,1150,30
吉野家,東京都,吉野家 大泉学園北口店,東京都練馬区東大泉1丁目29‐7,1200,20230225,1100,100
吉野家,大阪府,吉野家 大池橋店,大阪府大阪市生野区中川西3丁目9‐1,1080,20230225,1030,50
吉野家,福岡県,吉野家 大池通り長丘店,福岡県福岡市南区長丘5丁目15‐1,980,20230225,950,30
吉野家,滋賀県,吉野家 大津堅田店,滋賀県大津市本堅田5丁目22‐9,1000,20230225,950,50
吉野家,滋賀県,吉野家 大津膳所店,滋賀県大津市におの浜3丁目1‐57,1000,20230225,970,30
吉野家,大阪府,吉野家 大日店,大阪府守口市大日町3丁目1‐13,1130,20230225,1030,100
吉野家,福岡県,吉野家 大野城店,福岡県大野城市瓦田4丁目12‐40,980,20230225,930,50
吉野家,奈良県,吉野家 大和郡山店,奈良県大和郡山市柳町80‐1,1000,20230225,930,70
吉野家,奈良県,吉野家 大和高田東室店,奈良県大和高田市曽大根1丁目1‐5,1000,20230225,930,70
吉野家,兵庫県,吉野家 滝野社インター店,兵庫県加東市北野647‐1,1030,20230225,1000,30
吉野家,東京都,吉野家 池袋メトロポリタン通り店,東京都豊島区西池袋1丁目4‐7,1250,20230225,1200,50
吉野家,東京都,吉野家 池袋北口店,東京都豊島区西池袋1丁目24‐1,1250,20230225,1200,50
吉野家,福岡県,吉野家 築港本町店,福岡県福岡市博多区神屋町9‐14,1050,20230225,1000,50
吉野家,大阪府,吉野家 中央大通深江橋店,大阪府大阪市東成区東今里2丁目2‐6,1100,20230225,1050,50
吉野家,大阪府,吉野家 中環松原丹南店,大阪府松原市丹南4丁目1‐4,1080,20230225,1030,50
吉野家,大阪府,吉野家 中環東大阪若江店,大阪府東大阪市若江南町3丁目8‐53,1080,20230225,1030,50
吉野家,愛知県,吉野家 中村公園店,愛知県名古屋市中村区太閤通9丁目15‐2,1050,20230225,1000,50
吉野家,大阪府,吉野家 中百舌鳥店,大阪府堺市北区百舌鳥梅町2丁3‐3,1080,20230225,1030,50
吉野家,東京都,吉野家 中野北口店,東京都中野区中野5丁目66‐3,1250,20230225,1200,50
吉野家,東京都,吉野家 中野野方店,東京都中野区野方5‐23‐6 ,1500,20230225,1400,100
吉野家,埼玉県,吉野家 朝霞台駅南口店,埼玉県朝霞市東弁財1丁目4‐17,1100,20230225,1000,100
吉野家,東京都,吉野家 調布駅前店,東京都調布市布田1丁目37‐16,1150,20230225,1100,50
吉野家,新潟県,吉野家 長岡リップス川崎店,新潟県長岡市川崎町1374‐5,980,20230225,950,30
吉野家,大阪府,吉野家 長居店,大阪府大阪市住吉区長居東4丁目2‐3,1080,20230225,1030,50
吉野家,兵庫県,吉野家 長田五番町店,兵庫県神戸市長田区五番町6丁目5‐1,1100,20230225,1030,70
吉野家,滋賀県,吉野家 長浜店,滋賀県長浜市八幡東町13‐1,1050,20230225,950,100
吉野家,大阪府,吉野家 長堀店,大阪府大阪市中央区島之内1丁目18‐5,1150,20230225,1100,50
吉野家,三重県,吉野家 津駅チャム店,三重県津市羽所町1191‐1,1000,20230225,950,50
吉野家,愛知県,吉野家 津島金柳店,愛知県津島市金柳町観音堂20,1050,20230225,1000,50
吉野家,大阪府,吉野家 鶴橋駅前店,大阪府大阪市東成区東小橋3丁目16‐2,1100,20230225,1030,70
吉野家,大阪府,吉野家 帝塚山店,大阪府大阪市阿倍野区帝塚山1丁目85‐2,1080,20230225,1030,50
吉野家,大阪府,吉野家 天下茶屋店,大阪府大阪市西成区岸里1丁目2‐9,1100,20230225,1030,70
吉野家,大阪府,吉野家 天神橋六丁目店,大阪府大阪市北区天神橋6丁目6‐19,1100,20230225,1030,70
吉野家,群馬県,吉野家 天川大島店,群馬県前橋市天川大島町1丁目33‐4,1000,20230225,950,50
吉野家,東京都,吉野家 田原町店,東京都台東区西浅草1丁目7‐20,1180,20230225,1150,30
吉野家,大阪府,吉野家 都島駅前店,大阪府大阪市都島区善源寺町1丁目5‐53,1100,20230225,1050,50
吉野家,茨城県,吉野家 土浦真鍋店,茨城県土浦市真鍋2丁目1‐28,1000,20230225,950,50
吉野家,埼玉県,吉野家 東浦和店,埼玉県さいたま市緑区東浦和8丁目1‐13,1100,20230225,1050,50
吉野家,東京都,吉野家 東銀座店,東京都中央区銀座3丁目11‐11,1200,20230225,1150,50
吉野家,大阪府,吉野家 東三国駅前店,大阪府大阪市淀川区東三国4丁目3‐12,1200,20230225,1030,170
吉野家,大阪府,吉野家 東大阪八戸ノ里店,大阪府東大阪市御厨南2丁目4‐3,1080,20230225,1030,50
吉野家,山口県,吉野家 徳山駅前店,山口県周南市有楽町2,980,20230225,950,30
吉野家,奈良県,吉野家 奈良広陵町店,奈良県北葛城郡広陵町大塚905‐1,1000,20230225,930,70
吉野家,福岡県,吉野家 那の川店,福岡県福岡市中央区白金2丁目11‐16,1000,20230225,950,50
吉野家,大阪府,吉野家 内環状線江坂店,大阪府吹田市穂波町6‐20,1100,20230225,1050,50
吉野家,埼玉県,吉野家 南越谷店,埼玉県越谷市南越谷1丁目23‐1,1050,20230225,1000,50
吉野家,大阪府,吉野家 南港通り平野店,大阪府大阪市平野区平野西1丁目1‐4,1080,20230225,1030,50
吉野家,東京都,吉野家 南池袋店,東京都豊島区南池袋2丁目26‐4,1250,20230225,1200,50
吉野家,兵庫県,吉野家 尼崎昭和通店,兵庫県尼崎市昭和通8丁目270‐1,1050,20230225,1000,50
吉野家,兵庫県,吉野家 尼崎尾浜店,兵庫県尼崎市尾浜町1丁目29‐1,1050,20230225,1000,50
吉野家,兵庫県,吉野家 尼宝線池尻店,兵庫県伊丹市池尻2‐1,1030,20230225,1000,30
吉野家,兵庫県,吉野家 尼宝線労災病院前店,兵庫県尼崎市稲葉元町3丁目21,1050,20230225,1000,50
吉野家,神奈川,吉野家 日吉駅前店,神奈川県横浜市港北区日吉本町1丁目22‐10,1200,20230225,1150,50
吉野家,福岡県,吉野家 博多バスターミナル店,福岡県福岡市博多区博多駅中央街2‐1,1100,20230225,1000,100
吉野家,福岡県,吉野家 博多祇園店,福岡県福岡市博多区祇園町6‐45,1000,20230225,950,50
吉野家,福岡県,吉野家 粕屋仲原店,福岡県糟屋郡粕屋町仲原2536‐4,980,20230225,950,30
吉野家,北海道,吉野家 函館神山店,北海道函館市神山2丁目205‐17,1000,20230225,980,20
吉野家,青森県,吉野家 八戸石堂店,青森県八戸市石堂2丁目21‐8,950,20230225,900,50
吉野家,滋賀県,吉野家 八日市インター店,滋賀県東近江市妙法寺町708,1050,20230225,1000,50
吉野家,京都府,吉野家 八幡久保田店,京都府八幡市八幡久保田35‐23,1050,20230225,1000,50
吉野家,大阪府,吉野家 八尾高安店,大阪府八尾市高安町北7丁目178‐6,1080,20230225,1030,50
吉野家,埼玉県,吉野家 飯能駅前店,埼玉県飯能市仲町11‐21,1000,20230225,990,10
吉野家,愛知県,吉野家 尾西店,愛知県一宮市三条道東45‐1,1050,20230225,1000,50
吉野家,愛知県,吉野家 尾張旭印場店,愛知県尾張旭市白鳳町2丁目32,1050,20230225,1000,50
吉野家,愛知県,吉野家 尾張旭三郷店,愛知県尾張旭市井田町1丁目85,1050,20230225,1000,50
吉野家,愛知県,吉野家 尾張一宮PA上り店,愛知県一宮市丹陽町三ツ井東金浦2709,1050,20230225,1000,50
吉野家,兵庫県,吉野家 姫路今宿店,兵庫県姫路市東今宿3‐1225‐1,1050,20230225,1000,50
吉野家,兵庫県,吉野家 姫路大津店,兵庫県姫路市大津区恵美酒町2丁目56‐1,1000,20230225,980,20
吉野家,兵庫県,吉野家 姫路中地店,兵庫県姫路市飾磨区構4‐94,1030,20230225,980,50
吉野家,兵庫県,吉野家 姫路保城店,兵庫県姫路市保城943‐1,1030,20230225,980,50
吉野家,大阪府,吉野家 布施駅前店,大阪府東大阪市長堂1‐1,1100,20230225,1030,70
吉野家,東京都,吉野家 府中中河原店,東京都府中市住吉町1丁目20‐1,1150,20230225,1100,50
吉野家,埼玉県,吉野家 武蔵浦和駅前店,埼玉県さいたま市南区別所7丁目7‐34,1200,20230225,1050,150
吉野家,東京都,吉野家 武蔵小金井駅前店,東京都小金井市本町2丁目5‐2,1150,20230225,1100,50
吉野家,京都府,吉野家 伏見南店,京都府京都市伏見区横大路下三栖辻堂町38‐1,1050,20230225,970,80
吉野家,福岡県,吉野家 福岡空港国内TB店,福岡県福岡市博多区大字下臼井778‐1,1100,20230225,1000,100
吉野家,広島県,吉野家 福山手城町店,広島県福山市手城町4丁目7‐10,1000,20230225,950,50
吉野家,広島県,吉野家 福山新涯店,広島県福山市新涯町5丁目34‐14,1000,20230225,950,50
吉野家,大阪府,吉野家 平野店,大阪府大阪市平野区平野元町7‐13,1080,20230225,1030,50
吉野家,兵庫県,吉野家 宝塚高松町店,兵庫県宝塚市高司5丁目1‐8,1030,20230225,980,50
吉野家,東京都,吉野家 豊洲市場店,東京都江東区豊洲6丁目5‐1,1200,20230225,1150,50
吉野家,大阪府,吉野家 豊中市役所前店,大阪府豊中市中桜塚3丁目10‐30,1100,20230225,1030,70
吉野家,大阪府,吉野家 豊中庄内店,大阪府豊中市庄内栄町4丁目21‐36,1100,20230225,1030,70
吉野家,埼玉県,吉野家 北越谷駅前店,埼玉県越谷市北越谷4丁目2‐9,1050,20230225,1000,50
吉野家,大阪府,吉野家 北花田店,大阪府堺市北区北花田町3丁32‐6,1080,20230225,1030,50
吉野家,東京都,吉野家 北新宿百人町店,東京都新宿区百人町1丁目24‐4,1250,20230225,1200,50
吉野家,大阪府,吉野家 北巽店,大阪府大阪市生野区巽北3丁目15‐24,1080,20230225,1030,50
吉野家,愛知県,吉野家 北名古屋店,愛知県北名古屋市井瀬木郷前9‐1,1050,20230225,1000,50
吉野家,大阪府,吉野家 枚方渚内野店,大阪府枚方市渚内野1丁目2‐5,1050,20230225,1030,20
吉野家,大阪府,吉野家 枚方東香里店,大阪府枚方市東香里南町52‐30,1100,20230225,1030,70
吉野家,鹿児島,吉野家 霧島店,鹿児島県霧島市国分野口町4‐26,950,20230225,930,20
吉野家,愛知県,吉野家 名駅サンロード店,愛知県名古屋市中村区名駅4丁目7‐25,1100,20230225,1050,50
吉野家,愛知県,吉野家 名駅西店,愛知県名古屋市中村区椿町1‐3,1100,20230225,1050,50
吉野家,愛知県,吉野家 名駅太閤通口店,愛知県名古屋市中村区椿町7‐4,1100,20230225,1050,50
吉野家,愛知県,吉野家 名岐一宮店,愛知県一宮市富士3丁目3‐6,1050,20230225,1000,50
吉野家,三重県,吉野家 名四長島店,三重県桑名市長島町福吉516,1050,20230225,1000,50
吉野家,愛知県,吉野家 名四飛島店,愛知県海部郡飛島村竹之郷2丁目2‐18,1050,20230225,1000,50
吉野家,愛知県,吉野家 名鉄堀田駅前店,愛知県名古屋市瑞穂区塩入町4‐15,1030,20230225,1000,30
吉野家,愛知県,吉野家 名鉄名古屋駅店,愛知県名古屋市中村区名駅1丁目2‐1,1100,20230225,1050,50
吉野家,兵庫県,吉野家 明石魚住町店,兵庫県明石市魚住町清水2360‐5,1000,20230225,980,20
吉野家,石川県,吉野家 野々市店,石川県野々市市粟田6丁目386,1000,20230225,950,50
吉野家,大阪府,吉野家 淀川通塚本店,大阪府大阪市淀川区塚本2丁目13‐20,1050,20230225,1030,20
吉野家,兵庫県,吉野家 立花駅前店,兵庫県尼崎市立花町1丁目3‐1,1050,20230225,1000,50
吉野家,東京都,吉野家 立川北口大通り店,東京都立川市曙町2丁目12‐2,1150,20230225,1100,50
吉野家,兵庫県,吉野家 龍野店,兵庫県たつの市龍野町富永796‐1,1030,20230225,980,50
吉野家,大阪府,吉野家 緑一丁目店,大阪府大阪市鶴見区緑1丁目19‐2,1100,20230225,1030,70
吉野家,大阪府,吉野家 臨海岸和田店,大阪府岸和田市下野町3丁目10‐39,1080,20230225,1030,50
吉野家,大阪府,吉野家 臨海二色の浜店,大阪府貝塚市澤877‐1,1080,20230225,1030,50
吉野家,大阪府,吉野家 臨海緑町店,大阪府堺市堺区緑町1丁14‐1,1080,20230225,1030,50
吉野家,埼玉県,吉野家 蓮田店,埼玉県蓮田市西新宿1丁目7,1100,20230225,1000,100
吉野家,和歌山,吉野家 和歌山宮街道店,和歌山県和歌山市太田564‐3,1050,20230225,950,100
吉野家,和歌山,吉野家 和歌山向店,和歌山県和歌山市向203‐1,1000,20230225,950,50
吉野家,和歌山,吉野家 和歌山築地橋店,和歌山県和歌山市舟津町1丁目10,1050,20230225,950,100
吉野家,埼玉県,吉野家 和光笹目通り店,埼玉県和光市丸山台3丁目10‐6,1150,20230225,1100,50
吉野家,埼玉県,吉野家 蕨駅前店,埼玉県蕨市塚越1丁目4‐1,1200,20230225,1050,150
松屋,東京都,松屋 京王八王子店,東京都八王子市東町1-1-20第6岩下ビル1F,1200,20230225,1100,100
松屋,兵庫県,松屋 今津店,兵庫県西宮市今津曙町1-1エキーマ今津1F,1050,20230225,1000,50
松屋,兵庫県,松屋 阪神西宮店,兵庫県西宮市田中町2-3,1050,20230225,1000,50
松屋,東京都,松屋 上野浅草口店,東京都台東区上野7-2-1,1320,20230225,1200,120
松屋,東京都,松屋 上野店,東京都台東区上野4-9-5,1320,20230225,1200,120
松屋,東京都,松屋 西八王子店,東京都八王子市台町4-47-11 飯田ビル1F,1200,20230225,1100,100
松屋,東京都,松屋 青梅河辺町店/松のや 青梅河辺町店,東京都青梅市河辺町8-1-2,1150,20230225,1100,50
松屋,東京都,松屋 青梅新町店,東京都青梅市新町9-2020,1150,20230225,1100,50
松屋,東京都,松屋 日野神明店,東京都日野市神明2-1-1,1150,20230225,1100,50
松屋,東京都,松屋 日野店,東京都日野市大坂上1-30-24,1150,20230225,1100,50
松屋,東京都,松屋 八王子店,東京都八王子市旭町7-1 豊栄ビル,1200,20230225,1100,100
松屋,東京都,松屋 豊田店,東京都日野市多摩平1-2-1,1150,20230225,1100,50
松屋,東京都,松屋 立川錦町店/マイカリー食堂 立川錦町店,東京都立川市錦町2-1-3 ,1300,20230225,1200,100
松屋,東京都,松屋 立川柴崎町店/松のや 立川柴崎町店,東京都立川市柴崎町6-10-8,1300,20230225,1200,100
松屋,東京都,松屋 立川店/マイカリー食堂 立川店,東京都立川市曙町2-12-15 立川金水ビル1F,1300,20230225,1200,100
松屋,東京都,松屋 立川北口店,東京都立川市曙町2丁目3番地3,1250,20230225,1200,50
