松屋,東京都,トゥックントゥックン 羽村店,東京都羽村市五ノ神1-2-12,1163,20240921,1150,13
松屋,神奈川,松のや 伊勢佐木町店/マイカリー食堂 伊勢佐木町店,神奈川県横浜市中区伊勢佐木町2-76-3,1162,20240921,1150,12
松屋,兵庫県,松のや 伊川谷店,兵庫県神戸市西区伊川谷町潤和1142-3,1080,20240921,1040,40
松屋,神奈川,松のや 下永谷店,神奈川県横浜市港南区下永谷5-3-10,1162,20240921,1150,12
松屋,大阪府,松のや 貝塚店,大阪府貝塚市小瀬1-28-13,1120,20240921,1100,20
松屋,神奈川,松のや 茅ヶ崎店,神奈川県茅ヶ崎市新栄町1-6 湘南ISビル,1162,20240921,1150,12
松屋,大阪府,松のや 萱島店/マイカリー食堂 萱島店,大阪府寝屋川市萱島本町19-11,1150,20240921,1080,70
松屋,福岡県,松のや 干隈店,福岡県福岡市早良区干隈3-29-6,1000,20240921,950,50
松屋,大阪府,松のや 関大前店/マイカリー食堂 関大前店,大阪府吹田市千里山東1-7-13,1150,20240921,1080,70
松屋,福岡県,松のや 久留米店,福岡県久留米市上津1-15-1,1100,20240921,1000,100
松屋,兵庫県,松のや 魚住店,兵庫県明石市魚住町清水28番3,1100,20240921,1040,60
松屋,東京都,松のや 京王八王子店/マイカリー食堂 京王八王子店,東京都八王子市明神町4-6-3,1163,20240921,1150,13
松屋,京都府,松のや 京都南インター店,京都府京都市伏見区中島秋ノ山町121,1080,20240921,1040,40
松屋,神奈川,松のや 橋本店/マイカリー食堂 橋本店,神奈川県相模原市緑区橋本6丁目2‐1,1162,20240921,1150,12
松屋,大阪府,松のや 金岡店,大阪府堺市北区金岡町192-1 Pモール,1120,20240921,1080,40
松屋,京都府,松のや 桂川店,京都府京都市南区久世上久世町524-1,1080,20240921,1040,40
松屋,兵庫県,松のや 権現湖PA(下り線)店,兵庫県加古川市志方町野尻769-14,1150,20240921,1100,50
松屋,神奈川,松のや 戸塚店,神奈川県横浜市戸塚区戸塚町104,1162,20240921,1130,32
松屋,大阪府,松のや 香里園店/マイカリー食堂 香里園店,大阪府寝屋川市香里南之町30-14,1150,20240921,1080,70
松屋,大阪府,松のや 高槻千代田町店,大阪府高槻市千代田町4-5,1130,20240921,1080,50
松屋,大阪府,松のや 今福鶴見店,大阪府大阪市鶴見区鶴見4-1-31,1150,20240921,1080,70
松屋,大阪府,松のや 堺東店/マイカリー食堂 堺東店,大阪府堺市堺区中瓦町2-3-12 きくやビル1階,1120,20240921,1080,40
松屋,大阪府,松のや 四天王寺前夕陽ケ丘店,大阪府大阪市天王寺区四天王寺1-7-11,1150,20240921,1080,70
松屋,兵庫県,松のや 志染店,兵庫県三木市志染町広野1丁目74,1060,20240921,1040,20
松屋,鹿児島,松のや 鹿児島宇宿店,鹿児島県鹿児島市宇宿2丁目24-16,1050,20240921,897,153
松屋,大阪府,松のや 小阪店,大阪府東大阪市御厨栄町2-17-9,1180,20240921,1130,50
松屋,大阪府,松のや 少路店,大阪府豊中市少路1-2-1,1150,20240921,1100,50
松屋,京都府,松のや 松井山手店,京都府京田辺市山手西2-1-1,1080,20240921,1040,40
松屋,大阪府,松のや 松原店,大阪府松原市上田8-14-13,1120,20240921,1100,20
松屋,東京都,松のや 沼袋店/マイカリー食堂 沼袋店,東京都中野区沼袋3-27-6 リバティハイツ高橋,1163,20240921,1150,13
松屋,神奈川,松のや 湘南台店/マイカリー食堂 湘南台店,神奈川県藤沢市湘南台1-13-1,1162,20240921,1150,12
松屋,東京都,松のや 上板橋店,東京都板橋区常盤台4-32-6,1163,20240921,1150,13
松屋,大阪府,松のや 深江橋店,大阪府大阪市城東区諏訪4-3-1 ロイヤル・プラザ1F,1200,20240921,1150,50
松屋,神奈川,松のや 杉田店/マイカリー食堂 杉田店,神奈川県横浜市磯子区杉田1-12-28 魚七フードビル,1162,20240921,1150,12
松屋,兵庫県,松のや 西鈴蘭台店,兵庫県神戸市北区鳴子2-1-5,1060,20240921,1040,20
松屋,大阪府,松のや 石橋店,大阪府池田市石橋1-3-10 MKビル1F,1150,20240921,1100,50
松屋,大阪府,松のや 摂津富田店/マイカリー食堂 摂津富田店,大阪府高槻市富田町1-8-21,1130,20240921,1080,50
松屋,宮城県,松のや 仙台中央店,宮城県仙台市青葉区中央3-6-3 2F,1050,20240921,1000,50
松屋,大阪府,松のや 千鳥橋店,大阪府大阪市此花区四貫島1-1-2 千鳥橋駅南館,1200,20240921,1100,100
松屋,神奈川,松のや 相武台前店,神奈川県座間市相武台1-35-5,1162,20240921,1130,32
松屋,神奈川,松のや 相模原店/マイカリー食堂 相模原店,神奈川県相模原市中央区相模原2-2-19 エイコーマンション1F,1162,20240921,1130,32
松屋,神奈川,松のや 相模原陽光台店,神奈川県相模原市中央区陽光台5-5-2,1162,20240921,1130,32
松屋,神奈川,松のや 相模大野店,神奈川県相模原市南区相模大野3-2-1 BONO相模大野ノースモール202,1162,20240921,1130,32
松屋,滋賀県,松のや 草津木川町店,滋賀県草津市木川町75-5,1100,20240921,1050,50
松屋,神奈川,松のや 大和店/マイカリー食堂 大和店,神奈川県大和市中央4-1-2近藤ビル,1162,20240921,1150,12
松屋,大阪府,松のや 池田店,大阪府池田市城南1-9-16,1150,20240921,1100,50
松屋,福岡県,松のや 中洲店,福岡県福岡市博多区中洲5-1-7,1100,20240921,1000,100
松屋,東京都,松のや 中野新橋店,東京都中野区弥生町2-28-9 ホワイトペースビル,1163,20240921,1150,13
松屋,東京都,松のや 町田店,東京都町田市原町田4-4-14,1163,20240921,1150,13
松屋,京都府,松のや 長岡天神店,京都府長岡京市天神1-30-1,1080,20240921,1040,40
松屋,愛知県,松のや 長良町店,愛知県名古屋市中川区長良町3-32,1200,20240921,1100,100
松屋,東京都,松のや 田無店,東京都西東京市田無町4-2-12,1163,20240921,1150,13
松屋,大阪府,松のや 藤阪店,大阪府枚方市津田北町1-3189-2,1130,20240921,1080,50
松屋,大阪府,松のや 堂島店,大阪府大阪市北区堂島2-1-34,1150,20240921,1100,50
松屋,徳島県,松のや 徳島南昭和町店,徳島県徳島市南昭和町2-34-1,1080,20240921,1000,80
松屋,兵庫県,松のや 姫路野里店,兵庫県姫路市城東町180,1100,20240921,1080,20
松屋,大阪府,松のや 瓢箪山店,大阪府東大阪市若草町5-2,1120,20240921,1080,40
松屋,神奈川,松のや 武蔵新城店,神奈川県川崎市中原区新城5-1-3 フクシマビル,1162,20240921,1150,12
松屋,東京都,松のや 武蔵新田店,東京都大田区矢口1-16-24,1163,20240921,1150,13
松屋,大阪府,松のや 服部店,大阪府豊中市服部西町5-18-2,1200,20240921,1100,100
松屋,神奈川,松のや 平塚店/マイカリー食堂 平塚店,神奈川県平塚市紅谷町5-14,1162,20240921,1150,12
松屋,愛知県,松のや 堀田店,愛知県名古屋市瑞穂区明前町11-6,1200,20240921,1100,100
松屋,神奈川,松のや 本厚木店/マイカリー食堂 本厚木店,神奈川県厚木市中町2-5-3 厚木ヤングヒルビル,1162,20240921,1150,12
松屋,兵庫県,松のや 明石店,兵庫県明石市大明石町1-6-1 パピオスあかし,1100,20240921,1040,60
松屋,東京都,松のや 野方店/マイカリー食堂 野方店,東京都中野区野方5-25-4,1163,20240921,1150,13
松屋,神奈川,松のや 野毛店,神奈川県横浜市中区野毛町3-160-4,1162,20240921,1150,12
松屋,京都府,松のや 椥辻店,京都府京都市山科区椥辻東潰34-2,1080,20240921,1040,40
松屋,兵庫県,松屋 JR尼崎店,兵庫県尼崎市長洲本通1-4-2 レジュールアッシュ尼崎駅前,1150,20240921,1100,50
松屋,沖縄県,松屋 うるま石川店,沖縄県うるま市石川白浜1-4-12,980,20240921,960,20
松屋,沖縄県,松屋 うるま赤道店/マイカリー食堂 うるま赤道店,沖縄県うるま市赤道256-4,1000,20240921,980,20
松屋,兵庫県,松屋 たつの店,兵庫県たつの市龍野町堂本369-3,1100,20240921,1050,50
松屋,東京都,松屋 ひばりが丘店,東京都西東京市ひばりが丘北3-3-14,1200,20240921,1150,50
松屋,京都府,松屋 ホテルユニゾ京都烏丸御池店,京都府京都市中京区堺町通押小路下る扇屋町661番,1060,20240921,1050,10
松屋,兵庫県,松屋 ユニゾイン神戸三宮店,兵庫県神戸市中央区布引町2-1-9 ユニゾイン神戸三宮1F,1100,20240921,1050,50
松屋,大阪府,松屋 阿倍野店,大阪府大阪市阿倍野区阿倍野筋2-4-49,1170,20240921,1100,70
松屋,鹿児島,松屋 姶良加治木店/松のや 姶良加治木店,鹿児島県姶良市加治木町木田2041-2,1050,20240921,1000,50
松屋,兵庫県,松屋 伊丹店,兵庫県伊丹市南町3-1-3,1100,20240921,1050,50
松屋,東京都,松屋 羽村店,東京都羽村市五ノ神4-15-11 シティープラザはむら1F,1200,20240921,1150,50
松屋,広島県,松屋 奥屋PA（上り線）店,広島県東広島市志和町奥屋字春日山365,1100,20240921,1000,100
松屋,沖縄県,松屋 沖縄知花店/松のや 沖縄知花店,沖縄県沖縄市知花5-16-20,1000,20240921,980,20
松屋,兵庫県,松屋 加古川平岡町店/マイカリー食堂 加古川平岡町店,兵庫県加古川市平岡町一色370-1,1150,20240921,1100,50
松屋,兵庫県,松屋 加古川野口町店,兵庫県加古川市野口町坂元45-1,1100,20240921,1050,50
松屋,大阪府,松屋 花園町店,大阪府大阪市西成区鶴見橋1-3-5 ピュアファースト花園1F,1180,20240921,1100,80
松屋,秋田県,松屋 花輪SA（下り線）店,秋田県鹿角市花輪字火付け附森65-3,951,20240921,950,1
松屋,秋田県,松屋 花輪SA（上り線）店,秋田県鹿角市花輪張渡11-24,951,20240921,950,1
松屋,大阪府,松屋 外環八尾店/マイカリー食堂 外環八尾店,大阪府八尾市志紀町南3-190-1,1180,20240921,1150,30
松屋,静岡県,松屋 掛川SC(下り線)店,静岡県掛川市倉真5968-4,1050,20240921,1000,50
松屋,福岡県,松屋 苅田店/松のや 苅田店,福岡県京都郡苅田町幸町4-4,1100,20240921,1000,100
松屋,大阪府,松屋 岸里店,大阪府大阪市西成区潮路1-10-1 林 岸里駅前ビル,1180,20240921,1100,80
松屋,大阪府,松屋 岸和田店,大阪府岸和田市土生町2-7-17,1114,20240921,1100,14
松屋,大阪府,松屋 喜連瓜破店,大阪府大阪市平野区喜連2-5-47 村瀬ビル1F,1150,20240921,1100,50
松屋,岐阜県,松屋 岐阜茜部店,岐阜県岐阜市茜部本郷3-159-3,1100,20240921,1080,20
松屋,岐阜県,松屋 岐阜則武店,岐阜県岐阜市則武西2-19-16,1100,20240921,1080,20
松屋,京都府,松屋 亀岡店,京都府亀岡市下矢田町2-35-5,1060,20240921,1008,52
松屋,愛知県,松屋 亀島店,愛知県名古屋市中村区則武本通1-36 マシュービル1F,1200,20240921,1150,50
松屋,京都府,松屋 吉祥院店/松のや 吉祥院店,京都府京都市南区吉祥院西ノ茶屋町63番,1110,20240921,1100,10
松屋,福岡県,松屋 吉塚店,福岡県福岡市博多区吉塚本町13-30,1100,20240921,1000,100
松屋,福岡県,松屋 久留米国分バイパス店/松のや 久留米国分バイパス店,福岡県久留米市国分町937-1、937-8,1100,20240921,1000,100
松屋,福岡県,松屋 久留米新合川店/松のや 久留米新合川店,福岡県久留米市新合川1-5-40,1100,20240921,1000,100
松屋,福岡県,松屋 久留米通町店,福岡県久留米市通町1-16,1100,20240921,1000,100
松屋,大阪府,松屋 京橋南店,大阪府大阪市都島区片町2-4-8 上室ビル,1200,20240921,1180,20
松屋,大阪府,松屋 京阪京橋店,大阪府大阪市都島区東野田町2-4-14,1200,20240921,1180,20
松屋,京都府,松屋 京都久御山店,京都府久世郡久御山町野村村東87-1,1100,20240921,1050,50
松屋,京都府,松屋 京都西院店,京都府京都市右京区西院高山寺町12-7,1060,20240921,1010,50
松屋,東京都,松屋 玉川学園前店,東京都町田市玉川学園2-11-21第17通南ビル,1163,20240921,1150,13
松屋,大阪府,松屋 近大前店,大阪府東大阪市小若江4-13-11 1F・2F,1150,20240921,1080,70
松屋,北海道,松屋 恵庭店/松のや 恵庭店,北海道恵庭市大町1丁目257-1、257-4、257-5、505（地番）,1010,20240921,1000,10
松屋,大阪府,松屋 恵美須町店,大阪府大阪市浪速区恵美須西2-1-32,1180,20240921,1100,80
松屋,兵庫県,松屋 権現湖PA(上り線)店,兵庫県加古川市平荘町中山1001-26,1150,20240921,1100,50
松屋,兵庫県,松屋 元町東口店,兵庫県神戸市中央区北長狭通4丁目1-12 鯉川ビル,1100,20240921,1050,50
松屋,神奈川,松屋 古淵店,神奈川県相模原市南区古淵1-7-1,1162,20240921,1150,12
松屋,滋賀県,松屋 五個荘店,滋賀県東近江市五個荘簗瀬町上川原5-2,1100,20240921,1050,50
松屋,兵庫県,松屋 御影店,兵庫県神戸市東灘区御影中町1-6-6 シティーホームズ御影,1100,20240921,1050,50
松屋,大阪府,松屋 御崎店,大阪府大阪市住之江区御崎7-15-21,1150,20240921,1100,50
松屋,愛知県,松屋 広小路本町店,愛知県名古屋市中区栄2-4-7,1200,20240921,1100,100
松屋,大阪府,松屋 江坂駅前店,大阪府吹田市豊津町14-31由谷エムワイビル,1170,20240921,1120,50
松屋,福岡県,松屋 行橋中央店/松のや 行橋中央店,福岡県行橋市中央1-13-26,1100,20240921,1000,100
松屋,埼玉県,松屋 高坂店,埼玉県東松山市元宿1-11-2,1078,20240921,1030,48
松屋,大阪府,松屋 高石店/松のや 高石店,大阪府高石市西取石8丁目115・119（地番）,1114,20240921,1100,14
松屋,兵庫県,松屋 今津店,兵庫県西宮市今津曙町1-1エキーマ今津1F,1130,20240921,1100,30
松屋,大阪府,松屋 今里店,大阪府大阪市東成区大今里西3-5-1 イル・ソーレ今里駅前,1170,20240921,1100,70
松屋,佐賀県,松屋 佐賀大財店/松のや 佐賀大財店,佐賀県佐賀市大財3-10-26,1100,20240921,1000,100
松屋,兵庫県,松屋 阪神西宮店,兵庫県西宮市田中町2-3,1130,20240921,1100,30
松屋,大阪府,松屋 堺大野芝店/松のや 堺大野芝店,大阪府堺市中区大野芝137-1,1150,20240921,1100,50
松屋,大阪府,松屋 堺東銀座街店,大阪府堺市堺区中瓦町2-2-9,1150,20240921,1100,50
松屋,東京都,松屋 桜美林学園店,東京都町田市根岸町1010-6,1163,20240921,1150,13
松屋,大阪府,松屋 三国店,大阪府大阪市淀川区三国本町3-30-13,1150,20240921,1100,50
松屋,兵庫県,松屋 三田駅前町店,兵庫県三田市駅前町19-10,1052,20240921,1050,2
松屋,兵庫県,松屋 三木店,兵庫県三木市別所町小林734-76,1100,20240921,1050,50
松屋,京都府,松屋 山科店,京都府京都市山科区安朱中小路町3-2,1058,20240921,1040,18
松屋,大阪府,松屋 四ツ橋店,大阪府大阪市西区北堀江1-2-14,1180,20240921,1110,70
松屋,京都府,松屋 四条大宮駅前店,京都府京都市下京区四条通大宮東入立中町492,1060,20240921,1010,50
松屋,鹿児島,松屋 鹿児島新栄店/松のや 鹿児島新栄店/マイカリー食堂 鹿児島新栄店,鹿児島県鹿児島市新栄町185番106,1050,20240921,1000,50
松屋,広島県,松屋 七塚原SA（下り線）店,広島県庄原市山内町560-4,1100,20240921,1000,100
松屋,広島県,松屋 七塚原SA（上り線）店,広島県庄原市山内町560-1,1100,20240921,1000,100
松屋,大阪府,松屋 若江岩田店,大阪府東大阪市岩田町3-11-5,1150,20240921,1080,70
松屋,福岡県,松屋 周船寺店/松のや 周船寺店,福岡県福岡市西区周船寺3-11-10,1100,20240921,1000,100
松屋,大阪府,松屋 住道店,大阪府大東市浜町9-10 住道駅前ビル,1180,20240921,1100,80
松屋,大阪府,松屋 住之江公園店,大阪府大阪市住之江区新北島1-1-7 ビックドックプラザ1F,1150,20240921,1100,50
松屋,大阪府,松屋 十三西口店,大阪府大阪市淀川区十三本町1-4-1,1150,20240921,1100,50
松屋,大阪府,松屋 十三東口店,大阪府大阪市淀川区十三東2-8-15,1150,20240921,1100,50
松屋,宮城県,松屋 春日PA（下り線）店,宮城県宮城郡利府町春日字二ツ石39-8,1050,20240921,1000,50
松屋,宮城県,松屋 春日PA（上り線）店,宮城県宮城郡利府町春日字筆沢5-3,1050,20240921,1000,50
松屋,福岡県,松屋 小倉駅前店,福岡県北九州市小倉北区京町2-5-13,1100,20240921,1000,100
松屋,福岡県,松屋 小倉片野店,福岡県北九州市小倉北区片野4-20-12,1100,20240921,1000,100
松屋,東京都,松屋 小平小川店,東京都小平市小川東町5-2-5,1200,20240921,1150,50
松屋,大阪府,松屋 庄内店,大阪府豊中市庄内西町2-22-10幸栄ビル1F,1150,20240921,1100,50
松屋,東京都,松屋 昭島松原町店,東京都昭島市松原町1-6-13 AGスクウェアビル1F,1200,20240921,1150,50
松屋,愛媛県,松屋 松山枝松店,愛媛県松山市枝松5-7-14,1050,20240921,1000,50
松屋,愛媛県,松屋 松山石井店,愛媛県松山市東石井4-11-8,1050,20240921,1000,50
松屋,愛媛県,松屋 松山大街道店,愛媛県松山市大街道2-3-6,1050,20240921,1000,50
松屋,愛知県,松屋 上前津店,愛知県名古屋市中区大須4-11-9,1200,20240921,1100,100
松屋,愛知県,松屋 植田一本松店,愛知県名古屋市天白区一本松2-701,1150,20240921,1100,50
松屋,兵庫県,松屋 新在家店,兵庫県神戸市灘区浜田町3-5-8 アーバンヴィレッジ六甲南,1100,20240921,1050,50
松屋,大阪府,松屋 新大阪東口店,大阪府大阪市東淀川区東中島1-20-9 新大阪池永ビル,1170,20240921,1120,50
松屋,大阪府,松屋 森ノ宮店,大阪府大阪市中央区森ノ宮中央1-2-24,1200,20240921,1130,70
松屋,大阪府,松屋 深江橋店,大阪府大阪市東成区深江北2-9-24 コルタ深江橋,1180,20240921,1130,50
松屋,兵庫県,松屋 神戸元町店,兵庫県神戸市中央区元町通2-8-14 オルタンシアビル1F,1100,20240921,1050,50
松屋,神奈川,松屋 生田店,神奈川県川崎市多摩区生田7-8-9,1162,20240921,1140,22
松屋,福岡県,松屋 西新店/マイカリー食堂 西新店,福岡県福岡市早良区西新5丁目1-2,1100,20240921,1000,100
松屋,大阪府,松屋 西中島店,大阪府大阪市淀川区西中島6-7-3,1150,20240921,1100,50
松屋,静岡県,松屋 静岡七ツ新屋店,静岡県静岡市清水区七ツ新屋328-1,1100,20240921,1050,50
松屋,静岡県,松屋 静岡池田店,静岡県静岡市駿河区池田404-1,1100,20240921,1050,50
松屋,静岡県,松屋 静岡八幡店,静岡県静岡市駿河区八幡2丁目3-17,1100,20240921,1050,50
松屋,大阪府,松屋 石橋駅前店,大阪府池田市石橋1-10-27,1150,20240921,1100,50
松屋,宮城県,松屋 仙台五橋店,宮城県仙台市若林区清水小路5-6 エステート五ツ橋,1050,20240921,1000,50
松屋,宮城県,松屋 仙台鹿島店,宮城県仙台市泉区市名坂字鹿島11,1050,20240921,1000,50
松屋,宮城県,松屋 仙台扇町店,宮城県仙台市宮城野区扇町5-5-1,1050,20240921,1000,50
松屋,宮城県,松屋 仙台大和町店,宮城県仙台市若林区大和町3-2-11,1050,20240921,1000,50
松屋,宮城県,松屋 仙台中央店,宮城県仙台市青葉区中央3-6-3 1F,1050,20240921,1000,50
松屋,宮城県,松屋 仙台中野栄店/松のや 仙台中野栄店,宮城県仙台市宮城野区中野字只屋敷45-1,1050,20240921,1000,50
松屋,宮城県,松屋 仙台定禅寺通り店,宮城県仙台市青葉区国分町3-3-5 リスズビル1F,1050,20240921,1000,50
松屋,宮城県,松屋 仙台南町通り店,宮城県仙台市青葉区一番町2-7-7,1050,20240921,1000,50
松屋,宮城県,松屋 仙台八乙女店,宮城県仙台市泉区上谷刈1-1-5,1050,20240921,1000,50
松屋,大阪府,松屋 泉大津店/松のや 泉大津店,大阪府泉大津市虫取町1-4-31,1114,20240921,1100,14
松屋,神奈川,松屋 相模原中央店,神奈川県相模原市中央区中央1-10-15,1162,20240921,1150,12
松屋,岐阜県,松屋 大垣店,岐阜県大垣市禾森町5-190,1100,20240921,1080,20
松屋,大阪府,松屋 大国町店,大阪府大阪市浪速区敷津東1-9-16,1180,20240921,1100,80
松屋,大阪府,松屋 大阪野田店,大阪府大阪市福島区吉野3-12-27,1200,20240921,1150,50
松屋,東京都,松屋 大泉学園町店,東京都練馬区大泉学園町7-15-20,1200,20240921,1150,50
松屋,東京都,松屋 大泉学園店,東京都練馬区東大泉1-37-3,1200,20240921,1150,50
松屋,東京都,松屋 大泉学園南口店,東京都練馬区東大泉5-41-14,1200,20240921,1150,50
松屋,滋賀県,松屋 大津店,滋賀県大津市別保3-2-55,1100,20240921,1050,50
松屋,大阪府,松屋 大東御供田店,大阪府大東市御供田3-7-41,1180,20240921,1100,80
松屋,大分県,松屋 大分駅前店,大分県大分市中央町1-1-24,1050,20240921,950,100
松屋,大分県,松屋 大分大在店/松のや 大分大在店,大分県大分市角子南2-1-17,1050,20240921,950,100
松屋,福岡県,松屋 大牟田店,福岡県大牟田市船津町459-2,1100,20240921,1000,100
松屋,福岡県,松屋 大名1丁目店,福岡県福岡市中央区大名1-1-10 大名TCビル,1100,20240921,1000,100
松屋,福岡県,松屋 大野城横峰店/松のや 大野城横峰店,福岡県大野城市横峯2丁目11番、1170-7-9、1171-4、5（地番）,1100,20240921,1000,100
松屋,東京都,松屋 鷹の台店,東京都小平市たかの台44-8長谷川ビル,1200,20240921,1150,50
松屋,大阪府,松屋 谷町九丁目店,大阪府大阪市天王寺区生玉前町1-21,1180,20240921,1120,60
松屋,大阪府,松屋 中崎町店,大阪府大阪市北区中崎1-6-15 中崎1丁目くさかビル1・2F,1200,20240921,1150,50
松屋,神奈川,松屋 中山店,神奈川県横浜市緑区寺山町87-7,1162,20240921,1140,22
松屋,大分県,松屋 中津店/松のや 中津店,大分県中津市大字上宮永339-2,1050,20240921,1000,50
松屋,大阪府,松屋 長瀬店,大阪府東大阪市菱屋西1-17-14,1150,20240921,1080,70
松屋,埼玉県,松屋 鶴ヶ島店,埼玉県川越市鯨井新田1-18,1078,20240921,1030,48
松屋,東京都,松屋 鶴川店,東京都町田市能ケ谷1-5-2 apple studio 1F,1163,20240921,1150,13
松屋,福岡県,松屋 天神店,福岡県福岡市中央区天神3-3-1 木下ビル,1100,20240921,1000,100
松屋,大阪府,松屋 天満橋店,大阪府大阪市中央区谷町2-8-1大手前M2ビル,1180,20240921,1160,20
松屋,奈良県,松屋 天理店/マイカリー食堂 天理店,奈良県天理市守目堂町106-2,1050,20240921,1020,30
松屋,宮崎県,松屋 都城店/松のや 都城店,宮崎県都城市平江町14号1番,1000,20240921,950,50
松屋,愛知県,松屋 東郷PA（下り線）店,愛知県日進市米野木町南山978-13,1150,20240921,1100,50
松屋,愛知県,松屋 東郷PA（上り線）店,愛知県日進市米野木町南山978-12,1150,20240921,1100,50
松屋,神奈川,松屋 東戸塚東口店,神奈川県横浜市戸塚区品濃町538-7,1200,20240921,1150,50
松屋,大阪府,松屋 東住吉中野店,大阪府大阪市東住吉区中野4-3-22,1150,20240921,1100,50
松屋,大阪府,松屋 東住吉湯里店,大阪府大阪市東住吉区湯里5-20-6,1150,20240921,1100,50
松屋,埼玉県,松屋 東松山店,埼玉県東松山市箭弓町1-12-8,1078,20240921,1030,48
松屋,大阪府,松屋 東大阪七軒家店/松のや 東大阪七軒家店,大阪府東大阪市七軒家31-他（地番）,1190,20240921,1120,70
松屋,大阪府,松屋 東大阪川田店/松のや 東大阪川田店,大阪府東大阪市川田1-15-8,1190,20240921,1120,70
松屋,東京都,松屋 東大和清水店,東京都東大和市清水5-1095-7,1200,20240921,1150,50
松屋,埼玉県,松屋 東武霞ヶ関店,埼玉県川越市霞ヶ関東1-2-22,1078,20240921,1030,48
松屋,徳島県,松屋 徳島鮎喰店,徳島県徳島市鮎喰町1-33-1（地番）,1080,20240921,1000,80
松屋,徳島県,松屋 徳島駅前店,徳島県徳島市寺島本町西1-59,1080,20240921,1000,80
松屋,徳島県,松屋 徳島常三島店,徳島県徳島市北常三島町2-52-1,1080,20240921,1000,80
松屋,徳島県,松屋 徳島南矢三店/マイカリー食堂 徳島南矢三店,徳島県徳島市南矢三3丁目724-7,1080,20240921,1000,80
松屋,奈良県,松屋 奈良駅前店,奈良県奈良市三条本町3番8号,1050,20240921,1020,30
松屋,奈良県,松屋 奈良三条大路店,奈良県奈良市三条大路3-2-21,1050,20240921,1020,30
松屋,福岡県,松屋 那珂川店/松のや 那珂川店,福岡県那珂川市片縄北6-17-8,1050,20240921,1000,50
松屋,大阪府,松屋 南津守店,大阪府大阪市西成区南津守6-6-46,1150,20240921,1100,50
松屋,大阪府,松屋 南方店/マイカリー食堂 南方店,大阪府大阪市淀川区西中島3-17-2,1150,20240921,1100,50
松屋,福岡県,松屋 二又瀬店,福岡県福岡市東区二又瀬15-10,1100,20240921,1000,100
松屋,兵庫県,松屋 尼崎アマドゥ店,兵庫県尼崎市道意町7-1,1130,20240921,1100,30
松屋,兵庫県,松屋 尼崎潮江店,兵庫県尼崎市潮江1-27-15,1150,20240921,1100,50
松屋,兵庫県,松屋 尼崎店,兵庫県尼崎市神田中通2-17,1200,20240921,1100,100
松屋,兵庫県,松屋 尼崎武庫の里店/松のや 尼崎武庫の里店,兵庫県尼崎市武庫の里1-11-1,1130,20240921,1050,80
松屋,大分県,松屋 日田店/松のや 日田店,大分県日田市大字十二町岸高586番4,1150,20240921,1100,50
松屋,静岡県,松屋 日本坂PA（上り線）店,静岡県焼津市石脇上字西阿原751番1,1100,20240921,1050,50
松屋,兵庫県,松屋 播磨町店,兵庫県加古郡播磨町南大中3-3-28,1100,20240921,1050,50
松屋,福岡県,松屋 博多駅前通り店/マイカリー食堂 博多駅前通り店,福岡県福岡市博多区博多駅前3丁目30-29 タイセイ第2ビル,1100,20240921,1000,100
松屋,福岡県,松屋 博多駅南店/マイカリー食堂 博多駅南店,福岡県福岡市博多区博多駅南1-3-10,1100,20240921,1000,100
松屋,兵庫県,松屋 白鳥PA（下り線）店,兵庫県姫路市打越字南西1346,1150,20240921,1100,50
松屋,大阪府,松屋 八尾南太子堂店/松のや 八尾南太子堂店,大阪府八尾市南太子堂6丁目76-1(地番),1180,20240921,1150,30
松屋,大阪府,松屋 八尾本町店,大阪府八尾市本町2-8-19,1150,20240921,1080,70
松屋,大阪府,松屋 肥後橋店,大阪府大阪市西区江戸堀1-2-14 肥後橋官報ビル,1200,20240921,1180,20
松屋,兵庫県,松屋 姫路花田店,兵庫県姫路市花田町1本松93番2 他,1100,20240921,1050,50
松屋,兵庫県,松屋 姫路飾磨店,兵庫県姫路市飾磨区今在家1066,1100,20240921,1050,50
松屋,兵庫県,松屋 姫路南店,兵庫県姫路市安田3-119,1150,20240921,1100,50
松屋,大阪府,松屋 浜寺店,大阪府堺市西区浜寺船尾町西5丁132-1,1150,20240921,1100,50
松屋,大阪府,松屋 布施店,大阪府東大阪市足代新町2-18,1150,20240921,1080,70
松屋,大阪府,松屋 布施南店/松のや 布施南店,大阪府東大阪市寿町3-10-19,1180,20240921,1150,30
松屋,兵庫県,松屋 武庫川店/マイカリー食堂 武庫川店,兵庫県尼崎市稲葉荘1-14-5,1100,20240921,1050,50
松屋,福井県,松屋 福井御幸店,福井県福井市御幸4-20-8,1100,20240921,1050,50
松屋,福井県,松屋 福井大和田店,福井県福井市大和田2-1304,1100,20240921,1050,50
松屋,福岡県,松屋 福岡箱崎店/マイカリー食堂 福岡箱崎店,福岡県福岡市東区東浜1-2-26,1100,20240921,1000,100
松屋,東京都,松屋 福生志茂店,東京都福生市志茂36-4,1200,20240921,1150,50
松屋,神奈川,松屋 淵野辺北口店,神奈川県相模原市中央区淵野辺3-19-9,1162,20240921,1150,12
松屋,愛知県,松屋 平針店/松のや 平針店,愛知県名古屋市天白区平針3-117,1150,20240921,1100,50
松屋,神奈川,松屋 平塚北金目店,神奈川県平塚市北金目2-4-33,1162,20240921,1150,12
松屋,兵庫県,松屋 宝塚安倉店,兵庫県宝塚市安倉南2-2-21,1100,20240921,1050,50
松屋,大阪府,松屋 放出店,大阪府大阪市鶴見区今津南1-7-29,1180,20240921,1100,80
松屋,神奈川,松屋 麻溝台店,神奈川県相模原市南区麻溝台1-5-6,1162,20240921,1150,12
松屋,大阪府,松屋 箕面店/マイカリー食堂 箕面店,大阪府箕面市半町3-14-20,1150,20240921,1100,50
松屋,愛知県,松屋 名駅西店/マイカリー食堂 名駅西店,愛知県名古屋市中村区亀島2-12-1,1200,20240921,1150,50
松屋,福岡県,松屋 姪浜店,福岡県福岡市西区内浜1-7-5 ウエストコート姪浜内,1100,20240921,1000,100
松屋,愛知県,松屋 野並店,愛知県名古屋市緑区鳴海町字杜若7-1,1150,20240921,1100,50
松屋,兵庫県,松屋 鈴蘭台店,兵庫県神戸市北区鈴蘭台北町1-9-1 ,1100,20240921,1050,50
松屋,兵庫県,松屋 六甲道店,兵庫県神戸市灘区備後町3丁目2-16 タウンコート六甲,1100,20240921,1050,50
松屋,京都府,松屋 六地蔵店,京都府京都市伏見区桃山町西尾10番1,1100,20240921,1050,50
松屋,神奈川,麦のトリコ 元住吉店,神奈川県川崎市中原区木月2-8-1,1162,20240921,1112,50
