吉野家,長崎県,吉野家 34号線長崎大村店,長崎県大村市松並1丁目370‐1,900,20220730,850,50
吉野家,長崎県,吉野家 57号線長崎諫早店,長崎県諫早市小川町1‐5,900,20220730,850,50
吉野家,東京都,吉野家 阿佐ヶ谷店,東京都杉並区成田東5丁目42‐10,1150,20220730,1100,50
吉野家,東京都,吉野家 荻窪北口店,東京都杉並区上荻1丁目15‐2,1150,20220730,1100,50
吉野家,東京都,吉野家 吉祥寺北店,東京都武蔵野市吉祥寺本町1丁目8‐3,1150,20220730,1100,50
吉野家,東京都,吉野家 金町北口店,東京都葛飾区東金町1丁目22‐11,1150,20220730,1100,50
吉野家,東京都,吉野家 高円寺駅前店,東京都杉並区高円寺北2丁目4‐7,1150,20220730,1100,50
吉野家,佐賀県,吉野家 佐賀環状東通り店,佐賀県佐賀市巨勢町大字牛島一本松415‐4,950,20220730,900,50
吉野家,長崎県,吉野家 佐世保下京店,長崎県佐世保市下京町1‐1,930,20220730,900,30
吉野家,東京都,吉野家 三鷹駅南口店,東京都三鷹市下連雀3丁目27‐9,1150,20220730,1100,50
吉野家,愛知県,吉野家 春日井店,愛知県春日井市鳥居松町1丁目15‐297,1200,20220730,1000,200
吉野家,東京都,吉野家 神保町店,東京都千代田区神田神保町2丁目7‐7,1200,20220730,1150,50
吉野家,東京都,吉野家 水道橋三崎町店,東京都千代田区神田三崎町2丁目1‐1,1200,20220730,1150,50
吉野家,東京都,吉野家 西荻窪駅前店,東京都杉並区西荻北3丁目19‐3,1150,20220730,1100,50
吉野家,長崎県,吉野家 長崎滑石店,長崎県長崎市滑石2‐1‐40,900,20220730,850,50
松屋,北海道,松のや すすきの店,北海道札幌市中央区南4条西3-1-1,1000,20220730,950,50
松屋,北海道,松のや 札幌駅前通店,北海道札幌市中央区北1条西3-3-11,1000,20220730,950,50
松屋,北海道,松屋 すすきの店,北海道札幌市中央区南4条西3-1-1,1000,20220730,950,50
松屋,埼玉県,松屋 越谷蒲生店,埼玉県越谷市蒲生南町15-4,1100,20220730,1000,100
松屋,埼玉県,松屋 越谷店/松のや 越谷店,埼玉県越谷市弥生町17-1,1100,20220730,1030,70
松屋,千葉県,松屋 京成大久保店,千葉県習志野市大久保1-21-12 ニューTKビル 1F,1050,20220730,1000,50
松屋,北海道,松屋 琴似店,北海道札幌市西区琴似一条2-6-8,980,20220730,900,80
松屋,三重県,松屋 桑名店,三重県桑名市中央町3-64-1,1100,20220730,1000,100
松屋,北海道,松屋 札幌駅前通店,北海道札幌市中央区北1条西3丁目3番地 敷島北一条ビル,1000,20220730,950,50
松屋,北海道,松屋 手稲前田店,北海道札幌市手稲区前田5条13-3-35,980,20220730,900,80
松屋,埼玉県,松屋 春日部豊町店,埼玉県春日部市豊町1-27-2,1100,20220730,1000,100
松屋,北海道,松屋 西町店,北海道札幌市西区西町北4-1-8,980,20220730,900,80
松屋,北海道,松屋 中の島店,北海道札幌市豊平区中の島2条6-1-6,980,20220730,900,80
松屋,千葉県,松屋 津田沼店,千葉県習志野市津田沼1-10-41 十番街ビル1F,1100,20220730,1000,100
松屋,千葉県,松屋 津田沼南口店,千葉県習志野市谷津7-9-16 京葉ビル2,1100,20220730,1000,100
松屋,千葉県,松屋 東船橋店,千葉県船橋市東船橋5-15-11,1100,20220730,1000,100
松屋,北海道,松屋 南郷通店,北海道札幌市白石区南郷通9丁目南5-10,1000,20220730,900,100
松屋,愛知県,松屋 豊田十塚店,愛知県豊田市十塚町4-23-1,1100,20220730,1000,100
松屋,北海道,松屋 北24条店,北海道札幌市北区北23条西4-2-41,980,20220730,900,80
松屋,北海道,松屋 北44条店,北海道札幌市東区北44条東1-1-30,980,20220730,900,80
松屋,北海道,松屋 麻生店,北海道札幌市北区北40条西4-2-5,980,20220730,900,80
松屋,埼玉県,松屋 野火止店,埼玉県新座市野火止4-7-29,1000,20220730,980,20
松屋,北海道,松屋 里塚店,北海道札幌市清田区里塚一条4-15-40,980,20220730,900,80
松屋,埼玉県,松屋 和光市駅前店,埼玉県和光市本町3-2 ステイパルビル,1200,20220730,1100,100
松屋,埼玉県,松屋 和光白子店/松のや 和光白子店,埼玉県和光市白子1-7-12,1200,20220730,1100,100
