吉野家,香川県,吉野家 11号線丸亀店,香川県丸亀市山北町45‐1,1100,20221029,1000,100
吉野家,佐賀県,吉野家 208号線佐賀大学前店,佐賀県佐賀市本庄町大字本庄字五本杉577‐1,950,20221029,900,50
吉野家,沖縄県,吉野家 330号線壺川店,沖縄県那覇市壺川2丁目1‐6,950,20221029,900,50
吉野家,佐賀県,吉野家 34号線佐賀店,佐賀県佐賀市卸本町5‐34,950,20221029,900,50
吉野家,和歌山,吉野家 42号線田辺店,和歌山県田辺市稲成町232‐7,1100,20221029,1000,100
吉野家,沖縄県,吉野家 58号線那覇新都心店,沖縄県那覇市天久2丁目6‐3,950,20221029,900,50
吉野家,愛知県,吉野家 平手店,愛知県名古屋市緑区平手南1丁目201,1200,20221029,1000,200
松屋,東京都,ステーキ屋松 三鷹店,東京都武蔵野市中町1-1-8 HN28ビル,1150,20221029,1100,50
松屋,東京都,マイカリー食堂 豊田店,東京都日野市多摩平1-2-18,1200,20221029,1100,100
松屋,北海道,松のや すすきの店,北海道札幌市中央区南4条西3-1-1,1150,20221029,1000,150
松屋,茨城県,松のや つくば東大通り店,茨城県つくば市天久保4-6-8,1000,20221029,950,50
松屋,埼玉県,松のや ふじみ野店/マイカリー食堂 ふじみ野店,埼玉県富士見市ふじみ野西1-20-2 第7マツモトビル106,1100,20221029,1000,100
松屋,兵庫県,松のや 伊川谷店,兵庫県神戸市西区伊川谷町潤和1142-3,1030,20221029,1000,30
松屋,岡山県,松のや 岡山厚生町店,岡山県岡山市北区厚生町2-12-15,1100,20221029,1000,100
松屋,神奈川,松のや 下永谷店,神奈川県横浜市港南区下永谷5-3-10,1200,20221029,1100,100
松屋,大阪府,松のや 花園町店,大阪府大阪市西成区鶴見橋1-3-24,1200,20221029,1030,170
松屋,静岡県,松のや 掛川PA(下り線)店,静岡県掛川市倉真5968-4,1150,20221029,1100,50
松屋,神奈川,松のや 茅ヶ崎店,神奈川県茅ヶ崎市新栄町1-6 湘南ISビル,1200,20221029,1080,120
松屋,大阪府,松のや 萱島店/マイカリー食堂 萱島店,大阪府寝屋川市萱島本町19-11,1100,20221029,1023,77
松屋,福岡県,松のや 干隈店,福岡県福岡市早良区干隈3-29-6,1050,20221029,920,130
松屋,福岡県,松のや 久留米店,福岡県久留米市上津1-15-1,1100,20221029,1000,100
松屋,兵庫県,松のや 魚住店,兵庫県明石市魚住町清水28番3,1200,20221029,980,220
松屋,京都府,松のや 京都南インター店,京都府京都市伏見区中島秋ノ山町121,1100,20221029,1000,100
松屋,京都府,松のや 桂川店,京都府京都市南区久世上久世町524-1,1000,20221029,980,20
松屋,京都府,松のや 向日町店,京都府向日市上植野町南淀井4,1100,20221029,1000,100
松屋,香川県,松のや 高松瓦町店,香川県高松市南新町5-5,1200,20221029,930,270
松屋,香川県,松のや 高松今里店,香川県高松市今里町2丁目30-14,1050,20221029,900,150
松屋,大阪府,松のや 高槻千代田町店,大阪府高槻市千代田町4-5,1200,20221029,1023,177
松屋,兵庫県,松のや 今津店/マイカリー食堂 今津店,兵庫県西宮市津門呉羽町1-34,1050,20221029,1000,50
松屋,大阪府,松のや 今福鶴見店,大阪府大阪市鶴見区鶴見4-1-31,1150,20221029,1030,120
松屋,兵庫県,松のや 三宮東店,兵庫県神戸市中央区旭通5-1-2,1200,20221029,1020,180
松屋,兵庫県,松のや 志染店,兵庫県三木市志染町広野1丁目74,1050,20221029,960,90
松屋,広島県,松のや 紙屋町店,広島県広島市中区紙屋町2-2-26 山本ビル,1200,20221029,1000,200
松屋,鹿児島,松のや 鹿児島宇宿店,鹿児島県鹿児島市宇宿2丁目24-16,1050,20221029,860,190
松屋,大阪府,松のや 小阪店,大阪府東大阪市御厨栄町2-17-9,1200,20221029,1030,170
松屋,大阪府,松のや 松原店,大阪府松原市上田8-14-13,1060,20221029,1030,30
松屋,千葉県,松のや 松戸店,千葉県松戸市本町4-4 GK松戸ビル,1200,20221029,1000,200
松屋,神奈川,松のや 湘南台店/マイカリー食堂 湘南台店,神奈川県藤沢市湘南台1-13-1,1100,20221029,1071,29
松屋,東京都,松のや 上板橋店,東京都板橋区常盤台4-32-6,1200,20221029,1100,100
松屋,大阪府,松のや 深江橋店,大阪府大阪市城東区諏訪4-3-1 ロイヤル・プラザ1F,1100,20221029,1030,70
松屋,茨城県,松のや 神栖店,茨城県神栖市大野原3-11-2,1050,20221029,1000,50
松屋,神奈川,松のや 杉田店/マイカリー食堂 杉田店,神奈川県横浜市磯子区杉田1-12-28 魚七フードビル,1100,20221029,1080,20
松屋,愛知県,松のや 瀬戸店,愛知県瀬戸市西原町2-88,1100,20221029,1000,100
松屋,兵庫県,松のや 西神南店,兵庫県神戸市西区井吹台西町1-1-2,1071,20221029,960,111
松屋,大阪府,松のや 石橋店,大阪府池田市石橋1-3-10 MKビル1F,1150,20221029,1030,120
松屋,宮城県,松のや 仙台扇町店,宮城県仙台市宮城野区扇町5-5-1,1050,20221029,1000,50
松屋,宮城県,松のや 仙台中央店,宮城県仙台市青葉区中央3-6-3 2F,1050,20221029,1000,50
松屋,大阪府,松のや 千鳥橋店,大阪府大阪市此花区四貫島1-1-2 千鳥橋駅南館,1200,20221029,1030,170
松屋,千葉県,松のや 千葉店/マイカリー食堂 千葉店,千葉県千葉市中央区富士見2-24-1,1100,20221029,1050,50
松屋,千葉県,松のや 千葉都町店/マイカリー食堂 千葉都町店,千葉県千葉市中央区都町4-6-1,1100,20221029,1050,50
松屋,埼玉県,松のや 川越西口店/マイカリー食堂 川越西口店,埼玉県川越市脇田本町6-8 栄光ビル1F,1100,20221029,1000,100
松屋,岡山県,松のや 倉敷玉島店,岡山県倉敷市玉島1丁目1394-2,1100,20221029,1000,100
松屋,神奈川,松のや 相模原陽光台店,神奈川県相模原市中央区陽光台5-5-2,1200,20221029,1071,129
松屋,埼玉県,松のや 草加店,埼玉県草加市氷川町2121-3,1100,20221029,1000,100
松屋,滋賀県,松のや 草津木川町店,滋賀県草津市木川町75-5,1100,20221029,950,150
松屋,奈良県,松のや 大和高田店,奈良県大和高田市曽大根122-7,1000,20221029,930,70
松屋,福岡県,松のや 中洲店,福岡県福岡市博多区中洲5-1-7,1030,20221029,1000,30
松屋,東京都,松のや 町田店,東京都町田市原町田4-4-14,1100,20221029,1072,28
松屋,京都府,松のや 長岡天神店,京都府長岡京市天神1-30-1,1050,20221029,980,70
松屋,愛知県,松のや 長良町店,愛知県名古屋市中川区長良町3-32,1313,20221029,1050,263
松屋,大阪府,松のや 堂島店,大阪府大阪市北区堂島2-1-34,1200,20221029,1050,150
松屋,徳島県,松のや 徳島南昭和町店,徳島県徳島市南昭和町2-34-1,1000,20221029,900,100
松屋,奈良県,松のや 奈良駅前店,奈良県奈良市大宮町1-1-10,1000,20221029,930,70
松屋,沖縄県,松のや 那覇小禄店/マイカリー食堂 那覇小禄店,沖縄県那覇市田原1丁目3番地1,1100,20221029,920,180
松屋,埼玉県,松のや 南越谷店/マイカリー食堂 南越谷店,埼玉県越谷市南越谷1-19-2アバンセ南越谷,1100,20221029,1000,100
松屋,千葉県,松のや 南行徳店,千葉県市川市相之川4-8-2,1080,20221029,1000,80
松屋,兵庫県,松のや 尼崎店,兵庫県尼崎市神田中通2-18-9,1030,20221029,1000,30
松屋,愛知県,松のや 半田店,愛知県半田市青山1-4-9,1150,20221029,1050,100
松屋,兵庫県,松のや 板宿店,兵庫県神戸市須磨区平田町2-2-2 板宿稲岡ビル,1100,20221029,1000,100
松屋,大阪府,松のや 姫島店,大阪府大阪市西淀川区姫里1-26-18,1200,20221029,1030,170
松屋,兵庫県,松のや 姫路野里店,兵庫県姫路市城東町180,1100,20221029,1000,100
松屋,静岡県,松のや 富士インター店,静岡県富士市伝法3104-1(地番),1100,20221029,1050,50
松屋,東京都,松のや 武蔵小金井店,東京都小金井市本町5-18-5 太平ビル1F,1150,20221029,1100,50
松屋,東京都,松のや 平井店,東京都江戸川区平井5-15-8 平井駅前ビルE棟,1200,20221029,1150,50
松屋,神奈川,松のや 平塚店/マイカリー食堂 平塚店,神奈川県平塚市紅谷町5-14,1250,20221029,1100,150
松屋,千葉県,松のや 北小金店,千葉県松戸市小金8,1000,20221029,984,16
松屋,東京都,松のや 本蓮沼店,東京都板橋区蓮沼町22-5,1200,20221029,1100,100
松屋,千葉県,松のや 幕張本郷店,千葉県千葉市花見川区幕張本郷1-3-7,1200,20221029,1000,200
松屋,兵庫県,松のや 明石店,兵庫県明石市大明石町1-6-1 パピオスあかし,1150,20221029,1000,150
松屋,千葉県,松のや 茂原店,千葉県茂原市高師台3-1-4,1100,20221029,1000,100
松屋,大阪府,松のや 野崎店/マイカリー食堂 野崎店,大阪府大東市南津の辺町21-40,1150,20221029,1023,127
松屋,和歌山,松のや 和歌山太田店/マイカリー食堂 和歌山太田店,和歌山県和歌山市太田4-5-1,1100,20221029,1000,100
松屋,埼玉県,松のや 蕨西口店/マイカリー食堂 蕨西口店,埼玉県蕨市中央1-23-1,1100,20221029,1000,100
松屋,埼玉県,松のや 蕨店,埼玉県蕨市塚越1-4-18,1150,20221029,1000,150
松屋,京都府,松のや 椥辻店,京都府京都市山科区椥辻東潰34-2,1100,20221029,1000,100
松屋,兵庫県,松屋 JR尼崎店,兵庫県尼崎市長洲本通1-4-2 レジュールアッシュ尼崎駅前,1050,20221029,1000,50
松屋,広島県,松屋 KOKO HOTEL広島駅前店,広島県広島市南区京橋町10-3,1100,20221029,1000,100
松屋,沖縄県,松屋 うるま石川店,沖縄県うるま市石川白浜1-4-12,1000,20221029,920,80
松屋,沖縄県,松屋 うるま赤道店/マイカリー食堂 うるま赤道店,沖縄県うるま市赤道256-4,1000,20221029,920,80
松屋,茨城県,松屋 かすみがうら店,茨城県かすみがうら市上稲吉1943-32,1100,20221029,1000,100
松屋,北海道,松屋 すすきの店,北海道札幌市中央区南4条西3-1-1,1200,20221029,1000,200
松屋,茨城県,松屋 つくば西大通り店/マイカリー食堂 つくば西大通り店,茨城県つくば市春日4-1-5,1200,20221029,950,250
松屋,茨城県,松屋 ひたちなか店,茨城県ひたちなか市市毛字原坪894-36,1071,20221029,1000,71
松屋,福島県,松屋 エイトタウン本宮店/松のや エイトタウン本宮店,福島県本宮市荒井字久保田132-8-5,1100,20221029,1000,100
松屋,愛知県,松屋 サテライト安城店,愛知県安城市住吉町荒曽根30‐8,1100,20221029,1000,100
松屋,京都府,松屋 ホテルユニゾ京都烏丸御池店,京都府京都市中京区堺町通押小路下る扇屋町661番,1100,20221029,1000,100
松屋,兵庫県,松屋 ユニゾイン神戸三宮店,兵庫県神戸市中央区布引町2-1-9 ユニゾイン神戸三宮1F,1030,20221029,1000,30
松屋,大阪府,松屋 阿倍野店,大阪府大阪市阿倍野区阿倍野筋2-4-49,1200,20221029,1050,150
松屋,鹿児島,松屋 姶良加治木店/松のや 姶良加治木店,鹿児島県姶良市加治木町木田2041-2,1100,20221029,1000,100
松屋,神奈川,松屋 伊勢原店,神奈川県伊勢原市桜台1-2-30 三協ビル,1200,20221029,1100,100
松屋,群馬県,松屋 伊勢崎宮子町店/松のや 伊勢崎宮子町店,群馬県伊勢崎市宮子町3426-1,1100,20221029,1050,50
松屋,兵庫県,松屋 伊丹店,兵庫県伊丹市南町3-1-3,1050,20221029,1000,50
松屋,愛知県,松屋 一宮店,愛知県一宮市赤見1-2-4,1100,20221029,1050,50
松屋,神奈川,松屋 稲田堤店/マイカリー食堂 稲田堤店,神奈川県川崎市多摩区菅2-1-1,1200,20221029,1100,100
松屋,栃木県,松屋 宇都宮オリオン通店,栃木県宇都宮市曲師町5-8 多喜屋ビル,1200,20221029,1000,200
松屋,栃木県,松屋 宇都宮簗瀬町店,栃木県宇都宮市簗瀬町1984-6,1100,20221029,1050,50
松屋,山口県,松屋 宇部店,山口県宇部市島1-1-2,1050,20221029,950,100
松屋,東京都,松屋 羽村店,東京都羽村市五ノ神4-15-11 シティープラザはむら1F,1200,20221029,1100,100
松屋,千葉県,松屋 浦安駅前店,千葉県浦安市当代島1-1-22,1150,20221029,1100,50
松屋,埼玉県,松屋 浦和太田窪店,埼玉県さいたま市南区大字太田窪2840-2,1100,20221029,1000,100
松屋,埼玉県,松屋 浦和仲町店/松のや 浦和仲町店,埼玉県さいたま市浦和区仲町1-2-9,1150,20221029,1100,50
松屋,埼玉県,松屋 浦和町谷店/松のや 浦和町谷店,埼玉県さいたま市桜区町谷2-1-1,1250,20221029,1100,150
松屋,埼玉県,松屋 浦和田島通店,埼玉県さいたま市南区四谷3-7-6,1200,20221029,1000,200
松屋,埼玉県,松屋 越谷下間久里店,埼玉県越谷市下間久里980-1,1150,20221029,1000,150
松屋,長野県,松屋 塩尻店/松のや 塩尻店,長野県塩尻市大門泉町13-8,1100,20221029,1000,100
松屋,広島県,松屋 奥屋PA（上り線）店,広島県東広島市志和町奥屋字春日山365,1000,20221029,950,50
松屋,神奈川,松屋 横浜店,神奈川県横浜市西区南幸2-1-3 相鉄ムービル,1200,20221029,1100,100
松屋,愛知県,松屋 岡崎北店,愛知県岡崎市鴨田町字広元196,1050,20221029,1000,50
松屋,岡山県,松屋 岡山駅西口店,岡山県岡山市北区駅元町22-13 西口駅前ビル,1200,20221029,980,220
松屋,岡山県,松屋 岡山駅前店,岡山県岡山市北区本町3-3,1050,20221029,980,70
松屋,岡山県,松屋 岡山下中野店/マイカリー食堂 岡山下中野店,岡山県岡山市北区下中野343-101,1100,20221029,980,120
松屋,岡山県,松屋 岡山十日市店,岡山県岡山市北区十日市西町5-28,1100,20221029,1000,100
松屋,岡山県,松屋 岡山商科大前店,岡山県岡山市北区津島西坂2-5-5,1000,20221029,980,20
松屋,大阪府,松屋 岡町店,大阪府豊中市中桜塚1-1-1ティオ阪急岡町1階,1100,20221029,1050,50
松屋,沖縄県,松屋 沖縄知花店/松のや 沖縄知花店,沖縄県沖縄市知花5-16-20,1000,20221029,920,80
松屋,山口県,松屋 下関稗田店,山口県下関市稗田中町9-31,1100,20221029,950,150
松屋,千葉県,松屋 下総中山店,千葉県船橋市本中山2-15-10,1200,20221029,1100,100
松屋,兵庫県,松屋 加古川平岡町店/マイカリー食堂 加古川平岡町店,兵庫県加古川市平岡町一色370-1,1071,20221029,1000,71
松屋,京都府,松屋 河原町店,京都府京都市中京区河原町通蛸薬師上る奈良屋町305番地,1100,20221029,1000,100
松屋,秋田県,松屋 花輪SA（下り線）店,秋田県鹿角市花輪字火付け附森65-3,1030,20221029,930,100
松屋,秋田県,松屋 花輪SA（上り線）店,秋田県鹿角市花輪張渡11-24,1000,20221029,930,70
松屋,千葉県,松屋 我孫子若松店,千葉県我孫子市若松140-1,1080,20221029,1050,30
松屋,静岡県,松屋 掛川SC(下り線)店,静岡県掛川市倉真5968-4,1000,20221029,950,50
松屋,愛知県,松屋 笠寺店/松のや 笠寺店,愛知県名古屋市南区千竈通7-8-1,1100,20221029,1050,50
松屋,東京都,松屋 葛西長島陸橋店/マイカリー食堂 葛西長島陸橋店,東京都江戸川区東葛西5-3-3,1313,20221029,1100,213
松屋,東京都,松屋 蒲田西口店/マイカリー食堂 蒲田西口店,東京都大田区西蒲田7-1-11,1200,20221029,1150,50
松屋,神奈川,松屋 茅ヶ崎店,神奈川県茅ヶ崎市新栄町8-8 コジマビル1F,1100,20221029,1071,29
松屋,神奈川,松屋 関内ベイスターズ通り店,神奈川県横浜市中区常盤町2-10  常盤不動産  ビル1F,1200,20221029,1100,100
松屋,群馬県,松屋 館林店,群馬県館林市松原3丁目16番5,1100,20221029,1050,50
松屋,香川県,松屋 丸亀柞原店,香川県丸亀市柞原町409-1,1100,20221029,1000,100
松屋,大阪府,松屋 岸里店,大阪府大阪市西成区潮路1-10-1 林 岸里駅前ビル,1100,20221029,1030,70
松屋,大阪府,松屋 岸和田店,大阪府岸和田市土生町2-7-17,1150,20221029,1030,120
松屋,和歌山,松屋 岩出店/マイカリー食堂 岩出店,和歌山県岩出市岡田4-1,1050,20221029,950,100
松屋,岐阜県,松屋 岐阜鏡島店,岐阜県岐阜市鏡島2009-1,1100,20221029,1030,70
松屋,和歌山,松屋 紀ノ川大橋店,和歌山県和歌山市湊1820-99,1200,20221029,900,300
松屋,京都府,松屋 亀岡店,京都府亀岡市下矢田町2-35-5,1100,20221029,1000,100
松屋,新潟県,松屋 亀田インター店,新潟県新潟市中央区姥ケ山63-1,1000,20221029,950,50
松屋,東京都,松屋 亀有店,東京都葛飾区亀有3-25-1,1200,20221029,1100,100
松屋,埼玉県,松屋 吉川店,埼玉県吉川市木売1-4-11,1100,20221029,1000,100
松屋,福岡県,松屋 吉塚店,福岡県福岡市博多区吉塚本町13-30,1080,20221029,1000,80
松屋,福岡県,松屋 久留米新合川店/松のや 久留米新合川店,福岡県久留米市新合川1-5-40,1200,20221029,1000,200
松屋,福岡県,松屋 久留米通町店,福岡県久留米市通町1-16,1100,20221029,1000,100
松屋,茨城県,松屋 牛久店,茨城県牛久市田宮町41-1,1150,20221029,1000,150
松屋,大阪府,松屋 京橋南店,大阪府大阪市都島区片町2-4-8 上室ビル,1200,20221029,1050,150
松屋,京都府,松屋 京都三条店,京都府京都市中京区三条通河原町東入中島町97,1100,20221029,1000,100
松屋,京都府,松屋 京都西院店,京都府京都市右京区西院高山寺町12-7,1050,20221029,1000,50
松屋,千葉県,松屋 京葉市川PA（下り線）店,千葉県市川市田尻1-5-1 京葉市川PA下り線内2階,1200,20221029,1100,100
松屋,埼玉県,松屋 狭山根岸店,埼玉県狭山市根岸1-8-34,1100,20221029,1000,100
松屋,埼玉県,松屋 狭山市駅前店,埼玉県狭山市入間川1-3-2,1150,20221029,1030,120
松屋,埼玉県,松屋 狭山店,埼玉県狭山市下奥富1366-2,1100,20221029,1000,100
松屋,北海道,松屋 琴似店,北海道札幌市西区琴似一条2-6-8,1100,20221029,980,120
松屋,大阪府,松屋 近大前店,大阪府東大阪市小若江4-13-11 1F・2F,1072,20221029,1030,42
松屋,石川県,松屋 金沢工大前店,石川県野々市市扇が丘8-8,1000,20221029,960,40
松屋,石川県,松屋 金沢示野店,石川県金沢市戸板西1-55,1100,20221029,1000,100
松屋,石川県,松屋 金沢昌永町店,石川県金沢市昌永町18-5,1200,20221029,1000,200
松屋,石川県,松屋 金沢増泉店,石川県金沢市神田2-2-25,1100,20221029,1000,100
松屋,大阪府,松屋 九条店,大阪府大阪市西区九条1-14-26,1100,20221029,1060,40
松屋,熊本県,松屋 熊本新市街店/松のや 熊本新市街店,熊本県熊本市中央区新市街9-4 熊本第一ファームビル1F,1100,20221029,900,200
松屋,福島県,松屋 郡山コスモス通店,福島県郡山市堤3-180,1050,20221029,1000,50
松屋,福島県,松屋 郡山駅前店,福島県郡山市駅前2-3-9 東京萬ビル,1100,20221029,920,180
松屋,福島県,松屋 郡山芳賀店,福島県郡山市芳賀3-1-23,1100,20221029,920,180
松屋,福岡県,松屋 穴生店,福岡県北九州市八幡西区穴生2-8-7,1100,20221029,950,150
松屋,千葉県,松屋 穴川オーツーパーク店,千葉県千葉市稲毛区園生町380-1,1100,20221029,1050,50
松屋,兵庫県,松屋 権現湖PA(上り線)店,兵庫県加古川市平荘町中山1001-26,1100,20221029,1050,50
松屋,兵庫県,松屋 元町東口店,兵庫県神戸市中央区北長狭通4丁目1-12 鯉川ビル,1100,20221029,1000,100
松屋,埼玉県,松屋 戸田駅前店,埼玉県戸田市大字新曽字柳原329-1,1200,20221029,1100,100
松屋,滋賀県,松屋 五個荘店,滋賀県東近江市五個荘簗瀬町上川原5-2,1100,20221029,1000,100
松屋,東京都,松屋 五反野店/マイカリー食堂 五反野店,東京都足立区足立4-29-8 重沢ビル1F,1200,20221029,1100,100
松屋,兵庫県,松屋 御影店,兵庫県神戸市東灘区御影中町1-6-6 シティーホームズ御影,1100,20221029,1000,100
松屋,大阪府,松屋 御崎店,大阪府大阪市住之江区御崎7-15-21,1100,20221029,1030,70
松屋,広島県,松屋 広島胡町店,広島県広島市中区胡町1-20永井興産胡町ビル1階,1030,20221029,1000,30
松屋,広島県,松屋 広島紙屋町店,広島県広島市中区大手町1-4-5 アロハビル1階,1100,20221029,1000,100
松屋,広島県,松屋 広島千田店,広島県広島市中区東千田町2-3-23,1200,20221029,1000,200
松屋,広島県,松屋 広島矢野店,広島県広島市安芸区矢野西1-2-5,1050,20221029,1000,50
松屋,青森県,松屋 弘前高田店/松のや 弘前高田店,青森県弘前市大字高田1-3-1,1100,20221029,950,150
松屋,愛知県,松屋 江南店,愛知県江南市高屋町西町112,1100,20221029,1050,50
松屋,滋賀県,松屋 甲賀水口店/松のや 甲賀水口店,滋賀県甲賀市水口町日電1-55,1100,20221029,1000,100
松屋,山梨県,松屋 甲府国母店/松のや 甲府国母店,山梨県甲府市大里町358-1,1200,20221029,1100,100
松屋,神奈川,松屋 綱島店,神奈川県横浜市港北区綱島西1-1-3   青柳ビル1F,1200,20221029,1100,100
松屋,福岡県,松屋 行橋中央店/松のや 行橋中央店,福岡県行橋市中央1-13-26,1200,20221029,1000,200
松屋,千葉県,松屋 行徳南店,千葉県市川市行徳駅前2-8-6,1200,20221029,1100,100
松屋,大阪府,松屋 香里園駅前店,大阪府寝屋川市香里南之町20-20,1100,20221029,1030,70
松屋,埼玉県,松屋 高坂店,埼玉県東松山市元宿1-11-2 松田ビル,1100,20221029,1000,100
松屋,群馬県,松屋 高崎駅前店,群馬県高崎市八島町17-10,1200,20221029,1050,150
松屋,群馬県,松屋 高崎下之城店,群馬県高崎市下之城町177-4,1100,20221029,1050,50
松屋,群馬県,松屋 高崎問屋町店,群馬県高崎市問屋町1-10-4,1100,20221029,1050,50
松屋,香川県,松屋 高松松島店/松のや 高松松島店,香川県高松市松島町3-19-8,1200,20221029,980,220
松屋,香川県,松屋 高松兵庫町店,香川県高松市兵庫町1番地20,950,20221029,900,50
松屋,香川県,松屋 高松木太店,香川県高松市木太町3838-1,1072,20221029,950,122
松屋,大阪府,松屋 高槻南口店,大阪府高槻市高槻町9-22 吉廣第二ビル 1.2F,1100,20221029,1050,50
松屋,東京都,松屋 国領店,東京都調布市国領町4-8-1,1100,20221029,1080,20
松屋,兵庫県,松屋 今津店,兵庫県西宮市今津曙町1-1エキーマ今津1F,1030,20221029,1000,30
松屋,長野県,松屋 佐久店,長野県佐久市岩村田北1-13-7,1100,20221029,1000,100
松屋,栃木県,松屋 佐野店/松のや 佐野店,栃木県佐野市浅沼町558-3,1150,20221029,1000,150
松屋,兵庫県,松屋 阪神西宮店,兵庫県西宮市田中町2-3,1100,20221029,1000,100
松屋,大阪府,松屋 桜川店,大阪府大阪市浪速区桜川3-1-24 丸ニビル,1150,20221029,1060,90
松屋,北海道,松屋 札幌駅前通店,北海道札幌市中央区北1条西3丁目3番地 敷島北一条ビル,1200,20221029,1000,200
松屋,愛知県,松屋 三河安城店,愛知県安城市緑町2-9-2,1100,20221029,1000,100
松屋,広島県,松屋 三原店/松のや 三原店,広島県三原市皆実1-25-17,1023,20221029,1000,23
松屋,大阪府,松屋 三国店,大阪府大阪市淀川区三国本町3-30-13,1071,20221029,1030,41
松屋,兵庫県,松屋 三木店,兵庫県三木市別所町小林734-76,1100,20221029,1000,100
松屋,京都府,松屋 山科店,京都府京都市山科区安朱中小路町3-2,1100,20221029,1000,100
松屋,山形県,松屋 山形深町店/松のや 山形深町店,山形県山形市深町1-2-28,1100,20221029,950,150
松屋,山口県,松屋 山口店,山口県山口市泉町9-37,1100,20221029,980,120
松屋,山口県,松屋 山口平川店,山口県山口市平井1456,1100,20221029,980,120
松屋,京都府,松屋 四条大宮駅前店,京都府京都市下京区四条通大宮東入立中町492,1050,20221029,1000,50
松屋,三重県,松屋 四日市日永店,三重県四日市市日永4-1-10,1050,20221029,1000,50
松屋,千葉県,松屋 市原白金通店,千葉県市原市白金町1-17,1100,20221029,1050,50
松屋,埼玉県,松屋 志木東口店,埼玉県志木市本町5-25-12 林ビル1F,1200,20221029,1100,100
松屋,福岡県,松屋 糸島店,福岡県糸島市神在西2丁目22番30号,1000,20221029,920,80
松屋,神奈川,松屋 鹿島田店,神奈川県川崎市幸区下平間135,1150,20221029,1100,50
松屋,広島県,松屋 七塚原SA（下り線）店,広島県庄原市山内町560-4,1050,20221029,1000,50
松屋,茨城県,松屋 取手店,茨城県取手市取手3-1-2 取手プラザ1F,1100,20221029,1000,100
松屋,北海道,松屋 手稲前田店,北海道札幌市手稲区前田5条13-3-35,1100,20221029,980,120
松屋,福岡県,松屋 周船寺店/松のや 周船寺店,福岡県福岡市西区周船寺3-11-10,1100,20221029,950,150
松屋,大阪府,松屋 住之江公園店,大阪府大阪市住之江区新北島1-1-7 ビックドックプラザ1F,1200,20221029,1030,170
松屋,愛知県,松屋 春日井南下原町店,愛知県春日井市西山町3-20-3,1100,20221029,1050,50
松屋,埼玉県,松屋 春日部店,埼玉県春日部市中央1-2-6  M6ビル  1F,1200,20221029,1000,200
松屋,大阪府,松屋 春木店,大阪府岸和田市春木若松町18-31,1100,20221029,1030,70
松屋,千葉県,松屋 初石店,千葉県流山市西初石3-100-19 森田ビル1F,1100,20221029,1050,50
松屋,埼玉県,松屋 所沢若狭店,埼玉県所沢市若狭4-2453-1,1200,20221029,1000,200
松屋,埼玉県,松屋 所沢上安松店,埼玉県所沢市大字上安松822-44,1100,20221029,1000,100
松屋,東京都,松屋 曙橋店,東京都新宿区住吉町1-17 ジェントリー市ヶ谷1F,1200,20221029,1150,50
松屋,和歌山,松屋 小雑賀店,和歌山県和歌山市小雑賀573-9,1150,20221029,900,250
松屋,栃木県,松屋 小山店,栃木県小山市駅南町6-28-22,1030,20221029,1000,30
松屋,福岡県,松屋 小倉駅前店,福岡県北九州市小倉北区京町2-5-13,1100,20221029,950,150
松屋,福岡県,松屋 小倉片野店,福岡県北九州市小倉北区片野4-20-12,1050,20221029,980,70
松屋,大阪府,松屋 庄内店,大阪府豊中市庄内西町2-22-10幸栄ビル1F,1060,20221029,1030,30
松屋,埼玉県,松屋 松原団地店,埼玉県草加市栄町3-1-9,1200,20221029,1000,200
松屋,千葉県,松屋 松戸七畝割店,千葉県松戸市松戸2303-16,1200,20221029,1050,150
松屋,千葉県,松屋 松戸松飛台店,千葉県松戸市松飛台259-5,1100,20221029,1050,50
松屋,愛媛県,松屋 松山萱町店,愛媛県松山市萱町6-53-1,930,20221029,920,10
松屋,愛媛県,松屋 松山枝松店,愛媛県松山市枝松5-7-14,1060,20221029,950,110
松屋,愛媛県,松屋 松山石井店,愛媛県松山市東石井4-11-8,1200,20221029,950,250
松屋,愛媛県,松屋 松山大街道店,愛媛県松山市大街道2-3-6,1050,20221029,920,130
松屋,長野県,松屋 松本駅前店,長野県松本市中央1-2-23 山平ビル,1200,20221029,1000,200
松屋,新潟県,松屋 上越藤野店/松のや 上越藤野店,新潟県上越市藤野新田1259,1100,20221029,950,150
松屋,神奈川,松屋 上溝店/松のや 上溝店,神奈川県相模原市中央区上溝3-16-1,1200,20221029,1100,100
松屋,山形県,松屋 上山店,山形県上山市仙石字梅ノ木774-1,1200,20221029,930,270
松屋,大阪府,松屋 上新庄店,大阪府大阪市東淀川区瑞光1-11-29 新高ビル1階,1060,20221029,1050,10
松屋,神奈川,松屋 上大岡駅前店,神奈川県横浜市港南区上大岡西1-16-15,1200,20221029,1100,100
松屋,神奈川,松屋 上大岡店,神奈川県横浜市港南区上大岡西2-1-19,1200,20221029,1100,100
松屋,長野県,松屋 上田秋和店,長野県上田市秋和492-5,1200,20221029,1000,200
松屋,愛知県,松屋 上飯田店,愛知県名古屋市北区上飯田通1-13,1100,20221029,1050,50
松屋,福島県,松屋 城清水店,福島県郡山市南1-2,1200,20221029,920,280
松屋,愛知県,松屋 植田一本松店,愛知県名古屋市天白区一本松2-701,1050,20221029,1000,50
松屋,大阪府,松屋 寝屋川店,大阪府寝屋川市高宮栄町10-2,1200,20221029,1030,170
松屋,新潟県,松屋 新潟駅前店,新潟県新潟市中央区東大通1-6-1,1100,20221029,950,150
松屋,新潟県,松屋 新潟見附店/マイカリー食堂 新潟見附店,新潟県見附市上新田町字下野沖514-1,1030,20221029,950,80
松屋,新潟県,松屋 新潟女池店,新潟県新潟市中央区女池5-7-10,1100,20221029,950,150
松屋,新潟県,松屋 新潟米山店,新潟県新潟市中央区米山5-14-5,1080,20221029,950,130
松屋,新潟県,松屋 新潟豊栄店,新潟県新潟市北区かぶとやま2-2-58,1100,20221029,950,150
松屋,新潟県,松屋 新潟万代シテイ店,新潟県新潟市中央区万代1-1-22,1000,20221029,950,50
松屋,愛媛県,松屋 新居浜店/松のや 新居浜店,愛媛県新居浜市外山町14-48,1071,20221029,1000,71
松屋,埼玉県,松屋 新座馬場店,埼玉県新座市馬場1-4-13,1200,20221029,1100,100
松屋,兵庫県,松屋 新在家店,兵庫県神戸市灘区浜田町3-5-8 アーバンヴィレッジ六甲南,1100,20221029,1000,100
松屋,東京都,松屋 新宿西口店,東京都新宿区西新宿1-13-3,1375,20221029,1200,175
松屋,埼玉県,松屋 新所沢東口店,埼玉県所沢市松葉町10-15,1100,20221029,1000,100
松屋,千葉県,松屋 新松戸西口店,千葉県松戸市新松戸2-21-103,1100,20221029,1050,50
松屋,大阪府,松屋 新大阪東口店,大阪府大阪市東淀川区東中島1-20-9 新大阪池永ビル,1100,20221029,1050,50
松屋,新潟県,松屋 新発田店/松のや 新発田店,新潟県新発田市小舟町1-7-6,1000,20221029,950,50
松屋,大阪府,松屋 森ノ宮店,大阪府大阪市中央区森ノ宮中央1-2-24,1150,20221029,1050,100
松屋,愛知県,松屋 森孝店,愛知県名古屋市守山区森孝4-507,1100,20221029,1050,50
松屋,大阪府,松屋 深江橋店,大阪府大阪市東成区深江北2-9-24 コルタ深江橋,1100,20221029,1030,70
松屋,兵庫県,松屋 神戸伊川谷店,兵庫県神戸市西区伊川谷町有瀬1304,1060,20221029,1000,60
松屋,兵庫県,松屋 神戸玉津店,兵庫県神戸市西区枝吉5丁目147番,1100,20221029,1000,100
松屋,兵庫県,松屋 神戸元町店,兵庫県神戸市中央区元町通2-8-14 オルタンシアビル1F,1100,20221029,1000,100
松屋,兵庫県,松屋 神戸新開地店,兵庫県神戸市兵庫区新開地4-6-26,1100,20221029,1000,100
松屋,福岡県,松屋 神松寺店,福岡県福岡市城南区神松寺1-22-45,1030,20221029,920,110
松屋,長野県,松屋 諏訪店,長野県諏訪市大字四賀字赤沼1825-1,1071,20221029,1000,71
松屋,埼玉県,松屋 吹上店,埼玉県鴻巣市鎌塚3-10-12,1200,20221029,1100,100
松屋,兵庫県,松屋 垂水店,兵庫県神戸市垂水区神田町3番18号ラ・メール垂水1F,1050,20221029,1000,50
松屋,茨城県,松屋 水戸バイパス店,茨城県水戸市元吉田町1435-7,1100,20221029,1000,100
松屋,茨城県,松屋 水戸東原店/松のや 水戸東原店,茨城県水戸市東原1‐3‐17,1200,20221029,1000,200
松屋,東京都,松屋 清瀬野塩店/マイカリー食堂 清瀬野塩店,東京都清瀬市野塩4-224-1,1200,20221029,1100,100
松屋,岩手県,松屋 盛岡アイーナ店,岩手県盛岡市盛岡駅西通1-7-1 いわて県民情報交流センター,1000,20221029,930,70
松屋,岩手県,松屋 盛岡駅前通店,岩手県盛岡市盛岡駅前通9-9,1000,20221029,930,70
松屋,岩手県,松屋 盛岡大通店,岩手県盛岡市大通1-7-5,980,20221029,930,50
松屋,埼玉県,松屋 西所沢店/松のや 西所沢店,埼玉県所沢市上新井5-15-15,1050,20221029,1000,50
松屋,福岡県,松屋 西新店/マイカリー食堂 西新店,福岡県福岡市早良区西新5丁目1-2,1100,20221029,950,150
松屋,千葉県,松屋 西千葉店,千葉県千葉市中央区春日2-19-9 西千葉西口ビル,1100,20221029,1050,50
松屋,千葉県,松屋 西船橋店,千葉県船橋市西船4-25-3,1200,20221029,1100,100
松屋,東京都,松屋 西大井店,東京都品川区西大井1-4-20コア・スターレ西大井ショッピングセンター,1200,20221029,1100,100
松屋,大阪府,松屋 西中島店,大阪府大阪市淀川区西中島6-7-3,1150,20221029,1050,100
松屋,北海道,松屋 西町店,北海道札幌市西区西町北4-1-8,1100,20221029,980,120
松屋,東京都,松屋 青砥店,東京都葛飾区青戸3-37-19,1200,20221029,1100,100
松屋,東京都,松屋 青梅新町店,東京都青梅市新町9-2020,1150,20221029,1100,50
松屋,静岡県,松屋 静岡七ツ新屋店,静岡県静岡市清水区七ツ新屋328-1,1100,20221029,1000,100
松屋,静岡県,松屋 静岡池田店,静岡県静岡市駿河区池田404-1,1150,20221029,1000,150
松屋,静岡県,松屋 静岡八幡店,静岡県静岡市駿河区八幡2丁目3-17,1050,20221029,1000,50
松屋,宮城県,松屋 仙台五橋店,宮城県仙台市若林区清水小路5-6 エステート五ツ橋,1200,20221029,950,250
松屋,宮城県,松屋 仙台鹿島店,宮城県仙台市泉区市名坂字鹿島11,1200,20221029,930,270
松屋,宮城県,松屋 仙台大和町店,宮城県仙台市若林区大和町3-2-11,1150,20221029,1000,150
松屋,宮城県,松屋 仙台中央店,宮城県仙台市青葉区中央3-6-3 1F,1030,20221029,950,80
松屋,宮城県,松屋 仙台定禅寺通り店,宮城県仙台市青葉区国分町3-3-5 リスズビル1F,1000,20221029,950,50
松屋,宮城県,松屋 仙台南町通り店,宮城県仙台市青葉区一番町2-7-7,1150,20221029,950,200
松屋,宮城県,松屋 仙台八乙女店,宮城県仙台市泉区上谷刈1-1-5,1100,20221029,930,170
松屋,千葉県,松屋 千葉幸町店,千葉県千葉市美浜区幸町2-21-30,1200,20221029,1050,150
松屋,大阪府,松屋 千里丘店/松のや 千里丘店,大阪府摂津市千里丘5-11-3,1100,20221029,1050,50
松屋,大阪府,松屋 千林大宮店,大阪府大阪市旭区森小路2-6-1,1100,20221029,1030,70
松屋,埼玉県,松屋 川越インター店,埼玉県川越市広栄町6-6,1150,20221029,1000,150
松屋,埼玉県,松屋 川越城下町店,埼玉県川越市城下町7-8,1200,20221029,1050,150
松屋,埼玉県,松屋 川越西口店,埼玉県川越市脇田本町1-7 川越駅西口ビル,1100,20221029,1030,70
松屋,神奈川,松屋 川崎京町店,神奈川県川崎市川崎区京町1-18-15,1200,20221029,1100,100
松屋,兵庫県,松屋 川西能勢口店/マイカリー食堂 川西能勢口店,兵庫県川西市栄町10-5パルティ川西101号,1100,20221029,1000,100
松屋,埼玉県,松屋 川島店/松のや 川島店,埼玉県比企郡川島町大字上伊草1214-1,1100,20221029,1050,50
松屋,大阪府,松屋 船場心斎橋店,大阪府大阪市中央区北久宝寺町3-6-10クマタカ第一ビル1・2階,1100,20221029,1060,40
松屋,群馬県,松屋 前橋上小出町店,群馬県前橋市上小出町2-41-7,1100,20221029,1050,50
松屋,東京都,松屋 巣鴨店/マイカリー食堂 巣鴨店,東京都豊島区巣鴨2丁目5-2,1130,20221029,1100,30
松屋,神奈川,松屋 相模大野店,神奈川県相模原市南区相模大野3-2-1 ボーノ相模大野ノースモール1階,1200,20221029,1100,100
松屋,埼玉県,松屋 草加清門町店,埼玉県草加市清門1丁目423-1,1050,20221029,1000,50
松屋,埼玉県,松屋 草加西口店,埼玉県草加市氷川町2125-4 ウシヤマビル,1200,20221029,1050,150
松屋,東京都,松屋 足立江北店,東京都足立区江北3丁目35番12号,1200,20221029,1100,100
松屋,千葉県,松屋 袖ヶ浦店,千葉県袖ケ浦市福王台3-12-4,1100,20221029,1000,100
松屋,岐阜県,松屋 多治見店,岐阜県多治見市白山町4-50,1200,20221029,1050,150
松屋,群馬県,松屋 太田飯塚町店,群馬県太田市飯塚町1443,1100,20221029,1050,50
松屋,大阪府,松屋 大国町店,大阪府大阪市浪速区敷津東1-9-16,1100,20221029,1050,50
松屋,大阪府,松屋 大阪茨木店,大阪府茨木市春日1-4-1,1100,20221029,1050,50
松屋,大阪府,松屋 大阪野田店,大阪府大阪市福島区吉野3-12-27,1200,20221029,1060,140
松屋,大阪府,松屋 大正千島店/松のや 大正千島店,大阪府大阪市大正区千島3‐4‐7,1200,20221029,1100,100
松屋,東京都,松屋 大泉学園町店,東京都練馬区大泉学園町7-15-20,1100,20221029,1080,20
松屋,東京都,松屋 大泉学園店,東京都練馬区東大泉1-37-3,1100,20221029,1080,20
松屋,愛知県,松屋 大曽根北店,愛知県名古屋市北区山田町4-72,1200,20221029,1050,150
松屋,神奈川,松屋 大倉山店/マイカリー食堂 大倉山店,神奈川県横浜市港北区大倉山3-1-28,1100,20221029,1071,29
松屋,東京都,松屋 大鳥居店,東京都大田区萩中3-6-5,1200,20221029,1100,100
松屋,滋賀県,松屋 大津店,滋賀県大津市別保3-2-55,1100,20221029,1000,100
松屋,大分県,松屋 大分駅前店,大分県大分市中央町1-1-24,1100,20221029,900,200
松屋,大分県,松屋 大分大在店/松のや 大分大在店,大分県大分市角子南2-1-17,1200,20221029,950,250
松屋,福岡県,松屋 大牟田店,福岡県大牟田市船津町459-2,1000,20221029,920,80
松屋,福岡県,松屋 大名1丁目店,福岡県福岡市中央区大名1-1-10大名TCビル,1150,20221029,1000,150
松屋,神奈川,松屋 大和渋谷店,神奈川県大和市渋谷5-4-1,1200,20221029,1100,100
松屋,神奈川,松屋 大和店,神奈川県大和市大和南1-3-4 登喜和ビル1F,1200,20221029,1100,100
松屋,大阪府,松屋 谷町九丁目店,大阪府大阪市天王寺区生玉前町1-21,1100,20221029,1060,40
松屋,北海道,松屋 中の島店,北海道札幌市豊平区中の島2条6-1-6,1072,20221029,980,92
松屋,福岡県,松屋 中洲店,福岡県福岡市博多区中洲5-1-7 SPOONビル1階,1050,20221029,1000,50
松屋,東京都,松屋 中野新橋店,東京都中野区弥生町2-23-3,1200,20221029,1150,50
松屋,東京都,松屋 中野通り店,東京都中野区中野5-68-9,1310,20221029,1200,110
松屋,東京都,松屋 町田店,東京都町田市原町田4-4-15,1200,20221029,1100,100
松屋,新潟県,松屋 長岡堺東町店,新潟県長岡市堺東町7,1200,20221029,950,250
松屋,新潟県,松屋 長岡店/松のや 長岡店,新潟県長岡市新組町2281-1,1050,20221029,950,100
松屋,大阪府,松屋 長居店,大阪府大阪市住吉区長居3-14-8,1200,20221029,1030,170
松屋,大阪府,松屋 長瀬店,大阪府東大阪市菱屋西1-17-14,1060,20221029,1030,30
松屋,長野県,松屋 長野鶴賀七瀬店,長野県長野市大字鶴賀578-1,1100,20221029,1000,100
松屋,長野県,松屋 長野柳原店,長野県長野市大字小島86-1,1100,20221029,1000,100
松屋,大阪府,松屋 鳥飼店,大阪府摂津市鳥飼本町3-16-59,1100,20221029,1050,50
松屋,千葉県,松屋 津田沼南口店,千葉県習志野市谷津7-9-16 京葉ビル2,1200,20221029,1100,100
松屋,東京都,松屋 椎名町店,東京都豊島区長崎1-2-4 バイオレットインA室,1200,20221029,1100,100
松屋,大阪府,松屋 通天閣店,大阪府大阪市浪速区恵美須西2-1-32,1100,20221029,1050,50
松屋,大阪府,松屋 鶴橋店,大阪府大阪市天王寺区下味原町3-13 鶴橋下味原ビル1F,1100,20221029,1050,50
松屋,埼玉県,松屋 鶴瀬店,埼玉県富士見市鶴馬2605-1,1200,20221029,1000,200
松屋,東京都,松屋 鶴川店,東京都町田市能ケ谷1-5-2 apple studio 1F,1150,20221029,1100,50
松屋,神奈川,松屋 天王町店,神奈川県横浜市保土ケ谷区天王町2-47-7,1200,20221029,1100,100
松屋,大阪府,松屋 天神橋六丁目店,大阪府大阪市北区本庄東1-6-22,1200,20221029,1080,120
松屋,大阪府,松屋 天満橋店,大阪府大阪市中央区谷町2-8-1大手前M2ビル,1200,20221029,1050,150
松屋,奈良県,松屋 天理店/マイカリー食堂 天理店,奈良県天理市守目堂町106-2,1100,20221029,900,200
松屋,大阪府,松屋 都島毛馬店,大阪府大阪市都島区毛馬町1-7-13,1100,20221029,1050,50
松屋,東京都,松屋 東久留米下里店,東京都東久留米市下里3-24-12,1200,20221029,1100,100
松屋,東京都,松屋 東久留米南町店,東京都東久留米市南町4-1-8,1200,20221029,1100,100
松屋,愛知県,松屋 東郷PA（下り線）店,愛知県日進市米野木町南山978-13,1100,20221029,1000,100
松屋,神奈川,松屋 東戸塚東口店,神奈川県横浜市戸塚区品濃町538-7,1100,20221029,1071,29
松屋,長野県,松屋 東御店,長野県東御市加沢1406-51,1050,20221029,1000,50
松屋,広島県,松屋 東広島西条店,広島県東広島市西条町寺家4828-1,1050,20221029,980,70
松屋,東京都,松屋 東高円寺店,東京都杉並区高円寺南1-6-5,1200,20221029,1150,50
松屋,大阪府,松屋 東住吉中野店,大阪府大阪市東住吉区中野4-3-22,1100,20221029,1030,70
松屋,埼玉県,松屋 東松山店,埼玉県東松山市箭弓町1-12-8 大谷ビル,1100,20221029,1000,100
松屋,大阪府,松屋 東大阪川田店/松のや 東大阪川田店,大阪府東大阪市川田1-15-8,1100,20221029,1050,50
松屋,東京都,松屋 東大和市駅前店,東京都東大和市南街5-93-13ビル・エール1階,1200,20221029,1100,100
松屋,東京都,松屋 東武練馬店,東京都板橋区徳丸3-1-26,1150,20221029,1100,50
松屋,東京都,松屋 東伏見店,東京都西東京市東伏見2-4-6高橋イーストビル,1200,20221029,1100,100
松屋,愛知県,松屋 藤が丘店,愛知県名古屋市名東区藤が丘164番地,1100,20221029,1050,50
松屋,大阪府,松屋 藤井寺駅前店,大阪府藤井寺市岡2-7-18,1220,20221029,1030,190
松屋,徳島県,松屋 徳島駅前店,徳島県徳島市寺島本町西1-59 阿波けんどビル,1050,20221029,900,150
松屋,徳島県,松屋 徳島常三島店,徳島県徳島市北常三島町2-52-1,1100,20221029,900,200
松屋,徳島県,松屋 徳島南矢三店/マイカリー食堂 徳島南矢三店,徳島県徳島市南矢三3丁目724-7,1100,20221029,900,200
松屋,奈良県,松屋 奈良駅前店,奈良県奈良市三条本町3番8号,1000,20221029,900,100
松屋,奈良県,松屋 奈良三条大路店,奈良県奈良市三条大路3-2-21,1050,20221029,900,150
松屋,大阪府,松屋 南茨木店,大阪府茨木市沢良宜西1-2-20,1100,20221029,1050,50
松屋,北海道,松屋 南郷通店,北海道札幌市白石区南郷通9丁目南5-10,1100,20221029,1000,100
松屋,大阪府,松屋 南森町駅前店,大阪府大阪市北区天神橋2丁目北1-3,1100,20221029,1050,50
松屋,兵庫県,松屋 尼崎アマドゥ店,兵庫県尼崎市道意町7-1,1050,20221029,1000,50
松屋,兵庫県,松屋 尼崎潮江店,兵庫県尼崎市潮江1-27-15,1100,20221029,1000,100
松屋,兵庫県,松屋 尼崎店,兵庫県尼崎市神田中通2-17,1100,20221029,1000,100
松屋,広島県,松屋 廿日市店,広島県廿日市市串戸1-12-5,1100,20221029,980,120
松屋,静岡県,松屋 日本平PA（下り線）店,静岡県静岡市駿河区国吉田字西原坪,1100,20221029,1000,100
松屋,茨城県,松屋 日立桜川町店,茨城県日立市桜川町2-4-12,1200,20221029,950,250
松屋,埼玉県,松屋 入間店/松のや 入間店,埼玉県入間市宮寺3186-9,1100,20221029,1030,70
松屋,埼玉県,松屋 入間東藤沢店/松のや 入間東藤沢店,埼玉県入間市東藤沢4-2-17,1100,20221029,1000,100
松屋,愛知県,松屋 入場店/松のや 入場店,愛知県名古屋市港区入場1-1303-1,1100,20221029,1060,40
松屋,愛知県,松屋 納屋橋店,愛知県名古屋市中村区名駅南1-3-14,1200,20221029,1100,100
松屋,兵庫県,松屋 播磨町店,兵庫県加古郡播磨町南大中3-3-28,1100,20221029,1000,100
松屋,北海道,松屋 買物公園通店,北海道旭川市2条通8丁目左1号,1000,20221029,980,20
松屋,福岡県,松屋 博多駅南店/マイカリー食堂 博多駅南店,福岡県福岡市博多区博多駅南1-3-10,1100,20221029,1000,100
松屋,新潟県,松屋 柏崎店,新潟県柏崎市東柳田23-3,1100,20221029,950,150
松屋,福島県,松屋 白河店,福島県西白河郡西郷村字豊作東1,1100,20221029,980,120
松屋,神奈川,松屋 白楽店,神奈川県横浜市神奈川区白楽118,1200,20221029,1100,100
松屋,東京都,松屋 白山店,東京都文京区向丘1-9-23,1150,20221029,1100,50
松屋,兵庫県,松屋 白鳥PA（下り線）店,兵庫県姫路市打越字南西1346,1100,20221029,1000,100
松屋,千葉県,松屋 八千代台西口店,千葉県八千代市八千代台北1-11,1150,20221029,1000,150
松屋,千葉県,松屋 八千代台東口店,千葉県八千代市八千代台東1-2-16 第7扇ビル,1100,20221029,1000,100
松屋,埼玉県,松屋 飯能双柳店,埼玉県飯能市双柳757-4,1100,20221029,1000,100
松屋,兵庫県,松屋 姫路花田店,兵庫県姫路市花田町1本松93番2 他,1200,20221029,1000,200
松屋,兵庫県,松屋 姫路大手前通店,兵庫県姫路市駅前町338,1200,20221029,1000,200
松屋,兵庫県,松屋 姫路南店,兵庫県姫路市安田3-119,1080,20221029,1000,80
松屋,京都府,松屋 百万遍店,京都府京都市左京区吉田泉殿町1-87番地,1200,20221029,1000,200
松屋,大阪府,松屋 浜寺店,大阪府堺市西区浜寺船尾町西5丁132-1,1050,20221029,1030,20
松屋,静岡県,松屋 浜松高竜店,静岡県浜松市中区寺島町1024,1200,20221029,1050,150
松屋,静岡県,松屋 浜松高林店,静岡県浜松市中区高林4-14-22,1100,20221029,1050,50
松屋,富山県,松屋 富山下赤江店,富山県富山市下赤江町1-1-69,1150,20221029,1050,100
松屋,富山県,松屋 富山掛尾店,富山県富山市掛尾町259,1100,20221029,1050,50
松屋,富山県,松屋 富山田中町店,富山県富山市田中町4-18-43,1200,20221029,1050,150
松屋,大阪府,松屋 富田店,大阪府高槻市富田町1-6-3,1100,20221029,1050,50
松屋,大阪府,松屋 布施南店/松のや 布施南店,大阪府東大阪市寿町3-10-19,1100,20221029,1030,70
松屋,東京都,松屋 浮間舟渡駅前店,東京都北区浮間4-32-20 松岡ビル,1200,20221029,1100,100
松屋,兵庫県,松屋 武庫川店/マイカリー食堂 武庫川店,兵庫県尼崎市稲葉荘1-14-5,1100,20221029,1000,100
松屋,東京都,松屋 武蔵新田店,東京都大田区矢口1-7-15イセモトビル,1200,20221029,1100,100
松屋,福井県,松屋 福井御幸店,福井県福井市御幸4-20-8,1030,20221029,1000,30
松屋,福井県,松屋 福井若杉店/マイカリー食堂 福井若杉店,福井県福井市若杉4丁目715,1200,20221029,1000,200
松屋,福井県,松屋 福井大和田店,福井県福井市大和田2-1304,1100,20221029,1000,100
松屋,福岡県,松屋 福岡箱崎店/マイカリー食堂 福岡箱崎店,福岡県福岡市東区東浜1-2-26,1200,20221029,1000,200
松屋,広島県,松屋 福山花園店,広島県福山市花園町2-5-34,1030,20221029,980,50
松屋,広島県,松屋 福山東店,広島県福山市東深津町3-23-8,1200,20221029,980,220
松屋,東京都,松屋 分倍河原店,東京都府中市片町2-22-1 山ニビル,1150,20221029,1100,50
松屋,兵庫県,松屋 宝塚安倉店,兵庫県宝塚市安倉南2-2-21,1100,20221029,1000,100
松屋,大阪府,松屋 放出店,大阪府大阪市鶴見区今津南1-7-29,1150,20221029,1030,120
松屋,愛知県,松屋 豊橋つつじが丘店,愛知県豊橋市つつじが丘1-6-10,1100,20221029,1000,100
松屋,愛知県,松屋 豊橋藤沢町店,愛知県豊橋市藤沢町138番,1050,20221029,1000,50
松屋,愛知県,松屋 豊山店,愛知県西春日井郡豊山町大字豊場字栄81,1150,20221029,1050,100
松屋,大阪府,松屋 豊中熊野町店/マイカリー食堂 豊中熊野町店,大阪府豊中市熊野町1-1-8,1200,20221029,1030,170
松屋,愛知県,松屋 豊田山之手店,愛知県豊田市山之手6-70,1030,20221029,1000,30
松屋,東京都,松屋 豊田店,東京都日野市多摩平1-2-1,1150,20221029,1100,50
松屋,愛知県,松屋 豊田東新町店,愛知県豊田市東新町5-20-1,1050,20221029,1000,50
松屋,北海道,松屋 北24条店,北海道札幌市北区北23条西4-2-41,1100,20221029,980,120
松屋,北海道,松屋 北44条店,北海道札幌市東区北44条東1-1-30,1200,20221029,980,220
松屋,埼玉県,松屋 北浦和東口店,埼玉県さいたま市浦和区北浦和3-2-8,1100,20221029,1000,100
松屋,千葉県,松屋 北習志野店,千葉県船橋市習志野台2-6-1 小林ビル,1050,20221029,1000,50
松屋,千葉県,松屋 北小金店,千葉県松戸市小金きよしヶ丘3-20-5,1100,20221029,1050,50
松屋,沖縄県,松屋 北谷美浜店/マイカリー食堂 北谷美浜店,沖縄県中頭郡北谷町美浜2-1-9,1100,20221029,920,180
松屋,岐阜県,松屋 北方町店,岐阜県本巣郡北方町高屋伊勢田2-74-1,1100,20221029,1030,70
松屋,埼玉県,松屋 北本店,埼玉県北本市深井6-151,1100,20221029,1050,50
松屋,神奈川,松屋 本厚木店,神奈川県厚木市中町2-4-16 トキワヤビル1F,1200,20221029,1100,100
松屋,埼玉県,松屋 本川越店,埼玉県川越市新富町2-33-1,1100,20221029,1030,70
松屋,福島県,松屋 本内店,福島県福島市本内字松川畑2-2,1030,20221029,920,110
松屋,千葉県,松屋 本八幡南口店,千葉県市川市南八幡4-6-7,1150,20221029,1100,50
松屋,北海道,松屋 麻生店,北海道札幌市北区北40条西4-2-5,1200,20221029,980,220
松屋,千葉県,松屋 幕張インター店/松のや 幕張インター店/マイカリー食堂 幕張インター店,千葉県習志野市鷺沼5-6-5,1080,20221029,1050,30
松屋,千葉県,松屋 末広街道店,千葉県千葉市中央区末広2-3-4,1100,20221029,1050,50
松屋,長野県,松屋 箕輪町店,長野県上伊那郡箕輪町三日町947-1,1030,20221029,1000,30
松屋,福岡県,松屋 姪浜店,福岡県福岡市西区内浜1-7-5 ウエストコート姪浜内,1000,20221029,950,50
松屋,千葉県,松屋 茂原店,千葉県茂原市道表2-12,1100,20221029,1050,50
松屋,大阪府,松屋 門真店/マイカリー食堂 門真店,大阪府門真市下島町30-13,1100,20221029,1030,70
松屋,愛知県,松屋 野並店,愛知県名古屋市緑区鳴海町字杜若7-1,1100,20221029,1050,50
松屋,埼玉県,松屋 与野駅前店,埼玉県さいたま市浦和区上木崎1-4-2,1100,20221029,1050,50
松屋,埼玉県,松屋 与野店/松のや 与野店,埼玉県さいたま市中央区上峰4-14-12,1100,20221029,1050,50
松屋,大阪府,松屋 淀屋橋店,大阪府大阪市中央区北浜3-2-25 京阪淀屋橋ビル,1150,20221029,1100,50
松屋,北海道,松屋 里塚店,北海道札幌市清田区里塚一条4-15-40,1050,20221029,980,70
松屋,京都府,松屋 立命館大前店,京都府京都市北区平野宮西町117-3,1100,20221029,1000,100
松屋,兵庫県,松屋 鈴蘭台店,兵庫県神戸市北区鈴蘭台北町1-9-1 ,1050,20221029,1000,50
松屋,兵庫県,松屋 六甲道店,兵庫県神戸市灘区備後町3丁目2-16 タウンコート六甲,1023,20221029,1000,23
松屋,京都府,松屋 六地蔵店,京都府京都市伏見区桃山町西尾10番1,1100,20221029,1000,100
松屋,和歌山,松屋 和歌山加納店/松のや 和歌山加納店,和歌山県和歌山市加納295-1（地番）,1100,20221029,950,150
松屋,和歌山,松屋 和歌山向店,和歌山県和歌山市向220-3,1200,20221029,900,300
松屋,大阪府,松屋 和泉中央駅店,大阪府和泉市いぶき野5-1-1,1100,20221029,1030,70
松屋,大阪府,松屋 和泉店,大阪府和泉市富秋町3-2-36,1200,20221029,1030,170
松屋,東京都,松屋 糀谷店/松のや 糀谷店,東京都大田区西糀谷4-14-12,1200,20221029,1150,50
松屋,埼玉県,松屋フーズ 嵐山工場,埼玉県比企郡嵐山町花見台4-3,1050,20221029,1000,50
松屋,長野県,松乃家 上田店,長野県上田市国分1-9-8,1023,20221029,1000,23
松屋,山口県,松乃家 防府店,山口県防府市緑町2-5-16,1100,20221029,950,150
