吉野家,北海道,吉野家 36号線苫小牧店,北海道苫小牧市若草町3丁目2‐2,1000,20230311,980,20
吉野家,北海道,吉野家 38号線帯広店,北海道帯広市西1条南1‐1,1030,20230311,1000,30
吉野家,東京都,吉野家 6号線白鳥店,東京都葛飾区白鳥2丁目21‐24,1300,20230311,1200,100
吉野家,北海道,吉野家 環状通美園店,北海道札幌市豊平区美園4条6丁目3-10,1000,20230311,980,20
吉野家,北海道,吉野家 千歳店,北海道千歳市北栄2丁目1345番29,1000,20230311,980,20
吉野家,北海道,吉野家 大通西10丁目店,北海道札幌市中央区大通西10丁目4‐173,1000,20230311,980,20
吉野家,北海道,吉野家 苫小牧新開町店,北海道苫小牧市新開町2‐2‐2,1000,20230311,980,20
吉野家,北海道,吉野家 南郷通6丁目店,北海道札幌市白石区南郷通6丁目北42‐2,1000,20230311,980,20
吉野家,北海道,吉野家 羊ヶ丘通清田店,北海道札幌市清田区清田2条3丁目3,1000,20230311,980,20
すき家,宮崎県,すき家 10号宮崎大橋店,宮崎県宮崎市大橋2-30,980,20230311,950,30
すき家,宮崎県,すき家 10号宮崎島之内店,宮崎県宮崎市大字島之内997-1,950,20230311,920,30
すき家,宮崎県,すき家 10号高鍋店,宮崎県児湯郡高鍋町大字北高鍋2970-1,950,20230311,920,30
すき家,宮崎県,すき家 10号都城上町店,宮崎県都城市上町1-15,980,20230311,950,30
すき家,宮崎県,すき家 10号都城都北店,宮崎県都城市都北町5928-1,980,20230311,950,30
すき家,香川県,すき家 11号観音寺植田店,香川県観音寺市植田町字東原3-1,1020,20230311,1000,20
すき家,香川県,すき家 11号高松檀紙店,香川県高松市檀紙町1513-5,1000,20230311,980,20
すき家,香川県,すき家 11号東かがわ店,香川県東かがわ市白鳥字田高田131-1,1000,20230311,950,50
すき家,北海道,すき家 12号滝川東町店,北海道滝川市東町2-42-7,1000,20230311,960,40
すき家,東京都,すき家 14号江戸川一之江店,東京都江戸川区一之江1-8-4,1120,20230311,1100,20
すき家,東京都,すき家 14号江戸川篠崎店,東京都江戸川区篠崎町7-1-17,1120,20230311,1100,20
すき家,東京都,すき家 14号江戸川松江店,東京都江戸川区松江1-8-8,1120,20230311,1100,20
すき家,広島県,すき家 183号三次店,広島県三次市十日市中1-1-10,1030,20230311,1000,30
すき家,広島県,すき家 184号尾道店,広島県尾道市栗原西2-7-14,980,20230311,950,30
すき家,長野県,すき家 18号小諸店,長野県小諸市諸1-5-11,1000,20230311,960,40
すき家,山口県,すき家 190号宇部西割店,山口県宇部市大字妻崎開作871-2,970,20230311,950,20
すき家,静岡県,すき家 1国浜松卸本町店,静岡県浜松市南区卸本町103-1,1100,20230311,1030,70
すき家,大分県,すき家 210号大分わさだ店,大分県大分市市85-1,980,20230311,950,30
すき家,大分県,すき家 217号佐伯店,大分県佐伯市鶴岡町1-3-5,980,20230311,950,30
すき家,北海道,すき家 236号帯広大通店,北海道帯広市大通南3-1-1,1030,20230311,1000,30
すき家,北海道,すき家 238号紋別店,北海道紋別市落石町4-13-13,1100,20230311,1000,100
すき家,宮城県,すき家 23号多賀城町前店,宮城県多賀城市町前3-7-7,980,20230311,930,50
すき家,神奈川,すき家 255号小田原成田店,神奈川県小田原市成田408-1,1100,20230311,1090,10
すき家,神奈川,すき家 255号大井松田店,神奈川県足柄上郡大井町金子1627-1,1110,20230311,1090,20
すき家,宮崎県,すき家 269号宮崎清武店,宮崎県宮崎市清武町正手3-17-1,950,20230311,920,30
すき家,宮城県,すき家 286号仙台山田店,宮城県仙台市太白区山田字汚田通17-1,1000,20230311,950,50
すき家,山形県,すき家 287号長井店,山形県長井市東町6-31,950,20230311,900,50
すき家,岡山県,すき家 2国笠岡店,岡山県笠岡市三番町2-30,980,20230311,950,30
すき家,広島県,すき家 2国広島楽々園店,広島県広島市佐伯区楽々園2-2-22,1000,20230311,980,20
すき家,広島県,すき家 2国福山引野店,広島県福山市引野町5-19-30,980,20230311,960,20
すき家,広島県,すき家 2国福山高西店,広島県福山市高西町4-4-9,1000,20230311,980,20
すき家,広島県,すき家 2国福山南本庄店,広島県福山市南本庄2-7-4,980,20230311,960,20
すき家,静岡県,すき家 301号湖西店,静岡県湖西市古見字高田984-7,1100,20230311,1050,50
すき家,岡山県,すき家 313号真庭店,岡山県真庭市惣146-1,980,20230311,950,30
すき家,愛媛県,すき家 378号八幡浜店,愛媛県八幡浜市産業通13-12,1000,20230311,950,50
すき家,北海道,すき家 38号帯広柏林台店,北海道帯広市西十七条南1-25-1,1030,20230311,1000,30
すき家,鹿児島,すき家 3号薩摩川内店,鹿児島県薩摩川内市御陵下町字住連木14-18,970,20230311,950,20
すき家,鹿児島,すき家 3号鹿児島草牟田店,鹿児島県鹿児島市草牟田町3-1,950,20230311,920,30
すき家,広島県,すき家 432号竹原店,広島県竹原市下野町小井手3256-1,980,20230311,950,30
すき家,北海道,すき家 44号根室店,北海道根室市西浜町8-92-1,1000,20230311,950,50
すき家,広島県,すき家 486号備後府中店,広島県府中市高木町本堀田643-1,980,20230311,950,30
すき家,広島県,すき家 486号福山駅家店,広島県福山市駅家町万能倉288-1,980,20230311,950,30
すき家,宮城県,すき家 48号仙台折立店,宮城県仙台市青葉区折立1-21-20,980,20230311,930,50
すき家,東京都,すき家 4号足立保木間店,東京都足立区西保木間1-17-20,1120,20230311,1100,20
すき家,高知県,すき家 56号四万十古津賀店,高知県四万十市古津賀1-8,980,20230311,900,80
すき家,富山県,すき家 8号高岡北島店,富山県高岡市北島婦計459-2,1050,20230311,1030,20
すき家,島根県,すき家 9号浜田店,島根県浜田市熱田町1418-1,1000,20230311,950,50
すき家,東京都,すき家 JR町田駅南口店,東京都町田市原町田1-2-6第2ひろせビル1F,1120,20230311,1100,20
すき家,東京都,すき家 とうきょうスカイツリー駅前店,東京都墨田区業平1-18-12,1150,20230311,1120,30
すき家,島根県,すき家 ゆめタウン出雲店,島根県出雲市大塚町650-1,1000,20230311,950,50
すき家,東京都,すき家 アキバ田代通り店,東京都千代田区外神田4-5-8松孝商事ビル1F,1200,20230311,1150,50
すき家,兵庫県,すき家 イオンタウン太子店,兵庫県揖保郡太子町東出262-1,1000,20230311,980,20
すき家,香川県,すき家 イオンモール綾川店,香川県綾歌郡綾川町萱原822-1イオン綾川ショッピングセンター3F,1000,20230311,950,50
すき家,岡山県,すき家 イオンモール津山店,岡山県津山市河辺1000-1,980,20230311,950,30
すき家,東京都,すき家 イオン東雲店,東京都江東区東雲1-9-10イオン東雲店2Fフードコート内,1230,20230311,1200,30
すき家,東京都,すき家 グリナード永山店,東京都多摩市永山1-4グリナード永山1F,1100,20230311,1080,20
すき家,東京都,すき家 サンライズ蒲田店,東京都大田区西蒲田7-51-2ベルコーサ1F,1180,20230311,1150,30
すき家,東京都,すき家 フレスポ若葉台店,東京都稲城市若葉台2-1-1,1100,20230311,1080,20
すき家,東京都,すき家 綾瀬駅南店,東京都葛飾区小菅4-10-2,1120,20230311,1100,20
すき家,東京都,すき家 一之江駅前店,東京都江戸川区一之江3-2-14,1120,20230311,1100,20
すき家,東京都,すき家 稲荷町駅前店,東京都台東区東上野5-1-4,1150,20230311,1120,30
すき家,東京都,すき家 稲城矢野口店,東京都稲城市矢野口323-7,1120,20230311,1100,20
すき家,埼玉県,すき家 浦和仲町店,埼玉県さいたま市浦和区仲町1-4-12誠志堂ビル1F,1150,20230311,1100,50
すき家,神奈川,すき家 横浜北幸店,神奈川県横浜市西区北幸2-10-50北幸山田ビル1F,1200,20230311,1140,60
すき家,東京都,すき家 王子駅前店,東京都北区王子1-4-1サンスクエア前庭,1150,20230311,1120,30
すき家,岡山県,すき家 岡山西大寺店,岡山県岡山市東区松新町3-1,980,20230311,950,30
すき家,岡山県,すき家 岡山妹尾店,岡山県岡山市南区妹尾2342-1,1000,20230311,980,20
すき家,東京都,すき家 荻窪駅西口店,東京都杉並区荻窪5-26-11マチダビル1F,1180,20230311,1150,30
すき家,東京都,すき家 下石神井店,東京都練馬区下石神井5-16-3,1100,20230311,1080,20
すき家,兵庫県,すき家 加西北条店,兵庫県加西市北条町横尾294-1,1000,20230311,980,20
すき家,東京都,すき家 花小金井駅北口店,東京都小平市花小金井1-9-18花小金井第一ビル1F,1100,20230311,1080,20
すき家,神奈川,すき家 海老名河原口店,神奈川県海老名市河原口5-4-28,1150,20230311,1140,10
すき家,神奈川,すき家 海老名上河内店,神奈川県海老名市上河内297-3,1120,20230311,1090,30
すき家,東京都,すき家 葛飾亀有一丁目店,東京都葛飾区亀有1-14-5,1120,20230311,1100,20
すき家,東京都,すき家 葛飾柴又店,東京都葛飾区柴又5-9-1,1120,20230311,1100,20
すき家,東京都,すき家 葛飾南水元店,東京都葛飾区南水元2-30-5,1120,20230311,1100,20
すき家,東京都,すき家 環七山王店,東京都大田区山王4-12-4,1200,20230311,1150,50
すき家,東京都,すき家 環七西新井店,東京都足立区西新井本町2-2-25,1120,20230311,1100,20
すき家,東京都,すき家 環八蒲田四丁目店,東京都大田区蒲田4-42-12新生ビル1F,1200,20230311,1150,50
すき家,東京都,すき家 環八高井戸店,東京都杉並区高井戸西1-1-28,1180,20230311,1120,60
すき家,宮城県,すき家 岩沼中央店,宮城県岩沼市桜3-12-15,960,20230311,930,30
すき家,東京都,すき家 吉祥寺南店,東京都武蔵野市吉祥寺南町1-11-1,1200,20230311,1150,50
すき家,東京都,すき家 久米川駅前店,東京都東村山市栄町2-9-32晃正プラザビル1F,1100,20230311,1080,20
すき家,宮崎県,すき家 宮崎新別府店,宮崎県宮崎市新別府町山宮986-6,980,20230311,960,20
すき家,宮崎県,すき家 宮崎大島店,宮崎県宮崎市大島町松ノ木下292-1,980,20230311,920,60
すき家,宮崎県,すき家 宮崎東大淀店,宮崎県宮崎市東大淀2-3-41,980,20230311,950,30
すき家,東京都,すき家 玉川学園駅前店,東京都町田市玉川学園7-5-2,1100,20230311,1080,20
すき家,東京都,すき家 虎ノ門四丁目店,東京都港区虎ノ門4-1-19,1280,20230311,1200,80
すき家,東京都,すき家 五反野店,東京都足立区足立3-34-5沼野ビル,1120,20230311,1100,20
すき家,広島県,すき家 呉広店,広島県呉市広中町1-21,980,20230311,950,30
すき家,東京都,すき家 御徒町駅南口店,東京都台東区上野5-27-2,1200,20230311,1150,50
すき家,広島県,すき家 広島新天地店,広島県広島市中区新天地5-3ドンキ・ホーテ1F,1080,20230311,1050,30
すき家,広島県,すき家 広島八丁堀店,広島県広島市中区八丁堀1-8エイトビル,1080,20230311,1050,30
すき家,東京都,すき家 江東塩浜店,東京都江東区塩浜2-14-3,1200,20230311,1150,50
すき家,東京都,すき家 江東区役所前店,東京都江東区東陽4-10-7,1200,20230311,1150,50
すき家,東京都,すき家 江東千石店,東京都江東区千石2-9-9,1200,20230311,1150,50
すき家,神奈川,すき家 綱島駅西口店,神奈川県横浜市港北区綱島西1-10-10第5吉田ビル1F,1180,20230311,1140,40
すき家,東京都,すき家 高円寺駅南口店,東京都杉並区高円寺南4-45-2メインロードビル1F,1180,20230311,1150,30
すき家,香川県,すき家 高松郷東店,香川県高松市郷東町483-1,1000,20230311,950,50
すき家,香川県,すき家 高松寿町店,香川県高松市寿町1-4-3高松中央通りビル1F,1000,20230311,950,50
すき家,香川県,すき家 高松十川店,香川県高松市十川西町583-1,1000,20230311,950,50
すき家,香川県,すき家 高松上天神店,香川県高松市上天神町217-1,1000,20230311,950,50
すき家,香川県,すき家 高松中央IC店,香川県高松市木太町9区550-1,1000,20230311,950,50
すき家,鹿児島,すき家 国分野口店,鹿児島県霧島市国分野口東6-16,1000,20230311,970,30
すき家,神奈川,すき家 座間広野台店,神奈川県座間市広野台1-25-5,1110,20230311,1090,20
すき家,東京都,すき家 三鷹井口店,東京都三鷹市井口2-13-42,1130,20230311,1100,30
すき家,東京都,すき家 三田店,東京都港区芝5-25-9,1300,20230311,1250,50
すき家,山口県,すき家 山口維新公園前店,山口県山口市大字維新公園5-2-10,1000,20230311,980,20
すき家,山口県,すき家 山口大内店,山口県山口市大内千坊五丁目3-2,1000,20230311,980,20
すき家,鹿児島,すき家 鹿屋寿店,鹿児島県鹿屋市寿8-20-7,1000,20230311,970,30
すき家,鹿児島,すき家 鹿児島宇宿店,鹿児島県鹿児島市宇宿6-22-1,970,20230311,920,50
すき家,鹿児島,すき家 鹿児島下荒田店,鹿児島県鹿児島市下荒田1-2-1,970,20230311,950,20
すき家,鹿児島,すき家 鹿児島天文館店,鹿児島県鹿児島市呉服町1-3センチュリオンホテル鹿児島1F,950,20230311,920,30
すき家,鹿児島,すき家 鹿児島東谷山店,鹿児島県鹿児島市東谷山2-52-22,970,20230311,920,50
すき家,東京都,すき家 芝浦四丁目店,東京都港区芝浦4-9-18グランドパレス田町1F,1300,20230311,1250,50
すき家,東京都,すき家 芝四丁目店,東京都港区芝4-7-1西山ビル1F,1300,20230311,1250,50
すき家,東京都,すき家 秋葉原駅岩本町店,東京都千代田区岩本町3-3-5秋葉原SHビル1F,1200,20230311,1150,50
すき家,東京都,すき家 住吉新大橋通店,東京都江東区住吉2-2-7住吉Sビル1F,1150,20230311,1120,30
すき家,東京都,すき家 勝どき三丁目店,東京都中央区勝どき3-7-6,1230,20230311,1200,30
すき家,東京都,すき家 小金井中町店,東京都小金井市中町2-8-2,1130,20230311,1100,30
すき家,神奈川,すき家 小田原早川店,神奈川県小田原市早川3-19-6,1100,20230311,1090,10
すき家,東京都,すき家 小平中島町店,東京都小平市中島町22-19,1100,20230311,1080,20
すき家,東京都,すき家 小平鈴木店,東京都小平市鈴木町1-215-3,1100,20230311,1080,20
すき家,東京都,すき家 上石神井駅前店,東京都練馬区上石神井1-13-17,1100,20230311,1080,20
すき家,神奈川,すき家 新丸子駅東口店,神奈川県川崎市中原区新丸子東1-827クリア・ハウス田中1F,1200,20230311,1150,50
すき家,東京都,すき家 新御徒町店,東京都台東区東上野1-1-1,1200,20230311,1150,50
すき家,東京都,すき家 新宿南店,東京都新宿区新宿3-32-2,1250,20230311,1200,50
すき家,東京都,すき家 新宿二丁目店,東京都新宿区新宿2-15-15新宿ヤマトビル1F,1220,20230311,1200,20
すき家,東京都,すき家 新宿六丁目店,東京都新宿区新宿6-28-10,1200,20230311,1150,50
すき家,東京都,すき家 新青梅街道花小金井店,東京都小平市花小金井3-21-14,1100,20230311,1080,20
すき家,東京都,すき家 新青梅街道東村山店,東京都東村山市富士見町3-2-1,1100,20230311,1080,20
すき家,東京都,すき家 森下店,東京都江東区森下2-18-8,1150,20230311,1120,30
すき家,東京都,すき家 神谷町店,東京都港区虎ノ門3-19-7大手ビル1F,1280,20230311,1200,80
すき家,東京都,すき家 神田駅南店,東京都中央区日本橋室町4-3-11ds-Muromachi1F,1200,20230311,1150,50
すき家,東京都,すき家 神保町駅前店,東京都千代田区神田神保町1-14KDX神保町ビル1F,1150,20230311,1120,30
すき家,東京都,すき家 水道橋駅東口店,東京都千代田区神田三崎町1-4-26,1150,20230311,1120,30
すき家,東京都,すき家 瑞江店,東京都江戸川区瑞江2-1-23田所ビル1F,1120,20230311,1100,20
すき家,東京都,すき家 晴海二丁目店,東京都中央区晴海2-5-24晴海センタービル1F,1230,20230311,1200,30
すき家,東京都,すき家 西新宿五丁目駅前店,東京都新宿区西新宿4-3-12渡辺西新宿ビル1F,1200,20230311,1150,50
すき家,東京都,すき家 西新宿小滝橋通り店,東京都新宿区西新宿7-10-16千徳ビル,1200,20230311,1150,50
すき家,宮崎県,すき家 西都右松店,宮崎県西都市右松3-33,950,20230311,920,30
すき家,東京都,すき家 赤坂六丁目店,東京都港区赤坂6-3-1アスモビル,1280,20230311,1200,80
すき家,宮城県,すき家 仙台福室店,宮城県仙台市宮城野区福室字小原1-2,1000,20230311,980,20
すき家,神奈川,すき家 川崎駅前大通り店,神奈川県川崎市川崎区砂子2-6-27横山ビル1F,1220,20230311,1200,20
すき家,神奈川,すき家 川崎塩浜店,神奈川県川崎市川崎区四谷下町1-3,1250,20230311,1200,50
すき家,神奈川,すき家 川崎新川通り店,神奈川県川崎市川崎区渡田1-17-5石田ビル1F,1220,20230311,1200,20
すき家,神奈川,すき家 川崎藤崎店,神奈川県川崎市川崎区藤崎4-19-3,1250,20230311,1200,50
すき家,神奈川,すき家 川崎南加瀬店,神奈川県川崎市幸区南加瀬4-16-9,1200,20230311,1140,60
すき家,東京都,すき家 船堀駅前店,東京都江戸川区船堀3-5-7船堀駅前トキビル1F,1120,20230311,1100,20
すき家,兵庫県,すき家 相生垣内店,兵庫県相生市垣内町1310-7,1000,20230311,980,20
すき家,東京都,すき家 蔵前駅前店,東京都台東区蔵前2-6-6,1150,20230311,1120,30
すき家,東京都,すき家 足立一ツ家店,東京都足立区一ツ家1-15-6,1120,20230311,1100,20
すき家,東京都,すき家 足立栗原店,東京都足立区栗原4-9-6荒堀ビル1F,1120,20230311,1100,20
すき家,東京都,すき家 足立鹿浜店,東京都足立区鹿浜2-34-17,1120,20230311,1100,20
すき家,東京都,すき家 足立西綾瀬店,東京都足立区西綾瀬3-11-13,1120,20230311,1100,20
すき家,東京都,すき家 足立扇店,東京都足立区扇2-26-42,1120,20230311,1100,20
すき家,東京都,すき家 足立入谷店,東京都足立区入谷7-1-7フーファイゼンハウス1F,1120,20230311,1100,20
すき家,東京都,すき家 足立六木店,東京都足立区六木2-7-8,1120,20230311,1100,20
すき家,東京都,すき家 多摩乞田店,東京都多摩市乞田791-1,1120,20230311,1100,20
すき家,東京都,すき家 台東下谷店,東京都台東区下谷3-19-8,1150,20230311,1120,30
すき家,東京都,すき家 大久保二丁目店,東京都新宿区大久保2-6-18,1200,20230311,1150,50
すき家,東京都,すき家 大久保百人町店,東京都新宿区百人町1-16-14マキバビル1F,1200,20230311,1150,50
すき家,東京都,すき家 大森駅西口店,東京都大田区山王2-4-4,1200,20230311,1150,50
すき家,東京都,すき家 大田久が原店,東京都大田区久が原5-3-6,1180,20230311,1150,30
すき家,東京都,すき家 大田東邦医大通店,東京都大田区大森西1-8-17,1200,20230311,1150,50
すき家,東京都,すき家 築地四丁目店,東京都中央区築地4-12-2シグネットビル1F,1230,20230311,1200,30
すき家,東京都,すき家 竹芝店,東京都港区海岸1-9-11,1300,20230311,1250,50
すき家,北海道,すき家 中標津店,北海道標津郡中標津町東6条南11-1-2,1000,20230311,960,40
すき家,東京都,すき家 中野坂上店,東京都中野区中央2-30-2,1180,20230311,1150,30
すき家,東京都,すき家 町田高ヶ坂店,東京都町田市高ヶ坂6-4-1,1120,20230311,1100,20
すき家,東京都,すき家 町田小山店,東京都町田市小山町959-1,1100,20230311,1080,20
すき家,東京都,すき家 町田能ヶ谷店,東京都町田市能ヶ谷町7-12-11,1120,20230311,1100,20
すき家,東京都,すき家 調布入間店,東京都調布市入間町2-4-1,1120,20230311,1080,40
すき家,岡山県,すき家 津山小田中店,岡山県津山市小田中1301-1,980,20230311,950,30
すき家,香川県,すき家 津田の松原SA下り店,香川県さぬき市津田町鶴羽939-1,920,20230311,900,20
すき家,香川県,すき家 津田の松原SA上り店,香川県さぬき市津田町鶴羽935-5,920,20230311,900,20
すき家,神奈川,すき家 鶴屋町店,神奈川県横浜市神奈川区鶴屋町2-11-6,1200,20230311,1150,50
すき家,北海道,すき家 登別新生町店,北海道登別市新生町4-16-4,980,20230311,950,30
すき家,東京都,すき家 東雲晴海通り店,東京都江東区東雲1-6-17,1230,20230311,1200,30
すき家,東京都,すき家 東久留米下里店,東京都東久留米市下里2-6-7,1100,20230311,1080,20
すき家,東京都,すき家 東高円寺駅前店,東京都杉並区高円寺南1-7-1陽輪台高円寺1F,1180,20230311,1150,30
すき家,東京都,すき家 東村山秋津店,東京都東村山市秋津町3-47-3,1100,20230311,1080,20
すき家,山形県,すき家 南陽警察署西店,山形県南陽市椚塚字山崎1684-1,980,20230311,900,80
すき家,広島県,すき家 廿日市宮内店,広島県廿日市市宮内字北山1076-3,1050,20230311,1030,20
すき家,東京都,すき家 日本橋小伝馬町店,東京都中央区日本橋小伝馬町15-18EDGE小伝馬町ビル1F,1200,20230311,1150,50
すき家,東京都,すき家 八丁堀四丁目店,東京都中央区八丁堀4-8-2いちご桜橋ビル1F,1220,20230311,1200,20
すき家,東京都,すき家 不動前駅西店,東京都品川区西五反田4-29-14オザワSANTビル1F,1200,20230311,1150,50
すき家,広島県,すき家 福山蔵王店,広島県福山市南蔵王町5-16-23,980,20230311,960,20
すき家,東京都,すき家 文京白山店,東京都文京区向丘1-10-4,1150,20230311,1120,30
すき家,山口県,すき家 防府新田店,山口県防府市大字新田573-1,1000,20230311,980,20
すき家,山口県,すき家 防府天神店,山口県防府市天神2-3-36,1000,20230311,980,20
すき家,東京都,すき家 北新宿一丁目店,東京都新宿区北新宿1-12-12サンエスビル1F,1200,20230311,1150,50
すき家,東京都,すき家 北千住西口店,東京都足立区千住3-1-10,1120,20230311,1100,20
すき家,東京都,すき家 末広町店,東京都千代田区外神田6-15-14,1200,20230311,1150,50
すき家,東京都,すき家 木場店,東京都江東区木場5-11-19達摩堂ビル1F,1200,20230311,1150,50
すき家,東京都,すき家 立会川店,東京都品川区南大井1-6-10加藤ビル1F,1200,20230311,1150,50
すき家,広島県,すき家 立町店,広島県広島市中区立町2-1立町中央ビル1F,1080,20230311,1050,30
すき家,東京都,すき家 溜池山王店,東京都港区赤坂1-5-2外堀通ビル1F,1280,20230311,1200,80
すき家,東京都,すき家 練馬関町南店,東京都練馬区関町南1-11-2,1100,20230311,1080,20
すき家,東京都,すき家 練馬南大泉店,東京都練馬区南大泉1-17-17,1100,20230311,1080,20
すき家,東京都,すき家 六本木五丁目店,東京都港区六本木5-9-22第2千陽ビル1F,1280,20230311,1250,30
すき家,東京都,すき家 鶯谷店,東京都台東区根岸1-6-10,1150,20230311,1120,30
