吉野家,千葉県,吉野家 14号線幕張店,千葉県千葉市花見川区幕張町1丁目7780‐1,1050,20220604,1000,50
吉野家,三重県,吉野家 165号線名張店,三重県名張市夏見坊垣3222‐2,1000,20220604,950,50
吉野家,千葉県,吉野家 16号線下三ヶ尾店,千葉県野田市下三ケ尾404‐8,1050,20220604,1030,20
吉野家,千葉県,吉野家 16号線若柴店,千葉県柏市若柴5‐10,1110,20220604,1030,80
吉野家,千葉県,吉野家 16号線柏店,千葉県柏市柏931‐15,1050,20220604,1000,50
吉野家,千葉県,吉野家 16号線野田店,千葉県野田市船形2850‐1,1050,20220604,1030,20
吉野家,宮城県,吉野家 286号線西多賀店,宮城県仙台市太白区鈎取1丁目1‐8,1000,20220604,930,70
吉野家,宮城県,吉野家 45号線仙台日の出町店,宮城県仙台市宮城野区日の出町2丁目1‐16,1000,20220604,930,70
吉野家,青森県,吉野家 45号線八戸類家店,青森県八戸市類家4丁目1‐2,900,20220604,870,30
吉野家,沖縄県,吉野家 58号線北谷桑江店,沖縄県中頭郡北谷町桑江93‐3,1000,20220604,900,100
吉野家,青森県,吉野家 7号線青森西店,青森県青森市石江高間39‐1,900,20220604,870,30
吉野家,東京都,吉野家 JR神田駅店,東京都千代田区鍛冶町2丁目13‐26,1200,20220604,1150,50
吉野家,千葉県,吉野家 TX流山おおたかの森店,千葉県流山市西初石6‐182‐3,1050,20220604,1000,50
吉野家,沖縄県,吉野家 イオンタウン宮古南店,沖縄県宮古島市平良松原631,1000,20220604,900,100
吉野家,千葉県,吉野家 プレナ幕張店,千葉県千葉市美浜区ひび野2丁目4,1050,20220604,1000,50
吉野家,東京都,吉野家 羽田空港第1ターミナルビル店,東京都大田区羽田空港3丁目3‐2,1300,20220604,1200,100
吉野家,東京都,吉野家 秋葉原中央通り店,東京都千代田区外神田1丁目11‐8,1200,20220604,1150,50
吉野家,東京都,吉野家 秋葉原店,東京都千代田区神田松永町10‐1,1200,20220604,1150,50
吉野家,千葉県,吉野家 松戸みのり台店,千葉県松戸市稔台8丁目1‐6,1100,20220604,1000,100
吉野家,千葉県,吉野家 松戸西口店,千葉県松戸市本町20‐2,1050,20220604,1000,50
吉野家,千葉県,吉野家 松戸東口店,千葉県松戸市松戸1230‐1,1050,20220604,1000,50
吉野家,千葉県,吉野家 新京成八柱駅店,千葉県松戸市日暮1丁目1‐2,1050,20220604,1030,20
吉野家,青森県,吉野家 青森駅前店,青森県青森市新町1丁目1‐12,900,20220604,870,30
吉野家,千葉県,吉野家 船橋市場町店,千葉県船橋市市場2丁目2‐28,1050,20220604,1030,20
吉野家,東京都,吉野家 淡路町店,東京都千代田区神田須田町1丁目10‐1,1200,20220604,1150,50
吉野家,千葉県,吉野家 中山競馬場前店,千葉県市川市若宮3丁目48‐3,1050,20220604,1000,50
吉野家,千葉県,吉野家 柏西口店,千葉県柏市旭町1丁目4‐18,1050,20220604,1000,50
吉野家,千葉県,吉野家 柏東口店,千葉県柏市柏1丁目5‐19,1050,20220604,1000,50
吉野家,青森県,吉野家 八戸石堂店,青森県八戸市石堂2丁目21‐8,900,20220604,870,30
吉野家,東京都,吉野家 豊洲店,東京都江東区豊洲4丁目1‐1,1300,20220604,1200,100
吉野家,千葉県,吉野家 北小金店,千葉県松戸市根木内26,1050,20220604,1000,50
吉野家,千葉県,吉野家 流山店,千葉県流山市加4‐1643,1030,20220604,1000,30
松屋,埼玉県,すし松 三芳PA(上り線)店,埼玉県入間郡三芳町大字上冨2204,1200,20220604,1100,100
松屋,埼玉県,すし松 川口店,埼玉県川口市栄町3-5-12 石橋ビル,1100,20220604,1000,100
松屋,神奈川,松のや ホテルユニゾ横浜駅西店,神奈川県横浜市西区南幸2-17-6,1200,20220604,1100,100
松屋,東京都,松のや 江戸川橋店/マイカリー食堂 江戸川橋店,東京都文京区関口1-10-11 朝日江戸川橋マンション105号,1200,20220604,1100,100
松屋,東京都,松のや 麹町店/マイカリー食堂 麹町店 ,東京都千代田区麹町4-1-5,1200,20220604,1100,100
松屋,東京都,松のや 春日店/マイカリー食堂 春日店,東京都文京区本郷4-17-8,1200,20220604,1100,100
松屋,東京都,松のや 西新宿店,東京都新宿区西新宿7-1-7,1150,20220604,1100,50
松屋,東京都,松のや 石神井公園店/マイカリー食堂 石神井公園店,東京都練馬区石神井町3-25-2 大松ビル,1150,20220604,1100,50
松屋,東京都,松のや 中野坂上店,東京都中野区中央2-2-2,1150,20220604,1100,50
松屋,東京都,松のや 中野店,東京都中野区中野5-68-9 岸田ビル,1150,20220604,1100,50
松屋,東京都,松のや 東新宿店,東京都新宿区大久保1-3-14 ワールドビジネスセンター,1150,20220604,1100,50
松屋,東京都,松のや 武蔵境店,東京都武蔵野市境2-2-18 MHビル,1100,20220604,1050,50
松屋,東京都,松のや 武蔵小金井店,東京都小金井市本町5-18-5 太平ビル1F,1100,20220604,1050,50
松屋,東京都,松のや 方南町店,東京都杉並区方南2-18-1,1150,20220604,1100,50
松屋,東京都,松のや 用賀店,東京都世田谷区用賀2-38-15 田縁ビル,1200,20220604,1100,100
松屋,東京都,松のや 練馬店,東京都練馬区豊玉北5-19-12,1200,20220604,1100,100
松屋,茨城県,松屋 かすみがうら店,茨城県かすみがうら市上稲吉1943-32,1000,20220604,960,40
松屋,神奈川,松屋 伊勢原店,神奈川県伊勢原市桜台1-2-30 三協ビル,1100,20220604,1040,60
松屋,岡山県,松屋 岡山駅西口店,岡山県岡山市北区駅元町22-13 西口駅前ビル,980,20220604,930,50
松屋,岡山県,松屋 岡山駅前店,岡山県岡山市北区本町3-3,980,20220604,950,30
松屋,岡山県,松屋 岡山下中野店/マイカリー食堂 岡山下中野店,岡山県岡山市北区下中野343-101,980,20220604,950,30
松屋,岡山県,松屋 岡山商科大前店,岡山県岡山市北区津島西坂2-5-5,980,20220604,930,50
松屋,和歌山,松屋 岩出店,和歌山県岩出市岡田4-1,950,20220604,900,50
松屋,茨城県,松屋 牛久店,茨城県牛久市田宮町41-1,1000,20220604,950,50
松屋,神奈川,松屋 古淵店,神奈川県相模原市南区古淵1-7-1,1100,20220604,1040,60
松屋,静岡県,松屋 御殿場店,静岡県御殿場市川島田939-1,1100,20220604,1000,100
松屋,神奈川,松屋 厚木戸田店,神奈川県厚木市戸田540-1,1100,20220604,1040,60
松屋,神奈川,松屋 厚木店,神奈川県厚木市田村町7-2,1100,20220604,1040,60
松屋,山梨県,松屋 甲府荒川店,山梨県甲府市荒川1-8-32,1100,20220604,1000,100
松屋,山梨県,松屋 甲府国母店/松のや 甲府国母店,山梨県甲府市大里町358-1,1100,20220604,1000,100
松屋,神奈川,松屋 座間立野台店,神奈川県座間市立野台2-20-3,1100,20220604,1040,60
松屋,静岡県,松屋 三島店,静岡県三島市玉川243-1,1100,20220604,1000,100
松屋,山梨県,松屋 山梨昭和店,山梨県中巨摩郡昭和町飯喰字村西1131,1100,20220604,960,140
松屋,山梨県,松屋 山梨竜王店,山梨県甲斐市西八幡2234-1,1100,20220604,960,140
松屋,茨城県,松屋 取手店,茨城県取手市取手3-1-2 取手プラザ1F,1000,20220604,950,50
松屋,神奈川,松屋 小田急相模原西口店,神奈川県相模原市南区相模台2-4-6 K-フィネッサ,1100,20220604,1040,60
松屋,神奈川,松屋 小田急相模原店,神奈川県相模原市南区松が枝町24-6,1100,20220604,1040,60
松屋,静岡県,松屋 沼津店/松のや 沼津店,静岡県沼津市筒井町9-7,1100,20220604,1000,100
松屋,静岡県,松屋 沼津南店,静岡県沼津市上香貫字三園町1372番地,1100,20220604,1000,100
松屋,神奈川,松屋 上鶴間店,神奈川県相模原市南区上鶴間本町5丁目1番2号,1100,20220604,1040,60
松屋,神奈川,松屋 瀬谷店/マイカリー食堂 瀬谷店,神奈川県横浜市瀬谷区中央1-6,1100,20220604,1050,50
松屋,山梨県,松屋 石和店,山梨県笛吹市石和町広瀬1374,1100,20220604,960,140
松屋,千葉県,松屋 蘇我店,千葉県千葉市中央区今井2-1-1,1050,20220604,1000,50
松屋,神奈川,松屋 相模大野店,神奈川県相模原市南区相模大野3-2-1 ボーノ相模大野ノースモール1階,1100,20220604,1050,50
松屋,神奈川,松屋 大和店,神奈川県大和市大和南1-3-4 登喜和ビル1F,1100,20220604,1050,50
松屋,東京都,松屋 町田中町店,東京都町田市中町2-16-6,1100,20220604,1041,59
松屋,東京都,松屋 町田店,東京都町田市原町田4-4-15,1100,20220604,1041,59
松屋,神奈川,松屋 鶴間店,神奈川県大和市西鶴間1-2-9 TSURUMA017,1100,20220604,1050,50
松屋,東京都,松屋 鶴川店,東京都町田市能ケ谷1-5-2 apple studio 1F,1100,20220604,1041,59
松屋,茨城県,松屋 土浦真鍋店,茨城県土浦市真鍋1-12-9,1000,20220604,950,50
松屋,千葉県,松屋 東千葉店,千葉県千葉市中央区祐光2-15-5,1050,20220604,1000,50
松屋,神奈川,松屋 南林間店,神奈川県大和市南林間1-8-1,1100,20220604,1050,50
松屋,山梨県,松屋 韮崎店,山梨県韮崎市若宮2-12-20 ライフガーデンにらさき,1100,20220604,960,140
松屋,静岡県,松屋 富士ラウンドワン店,静岡県富士市八代町4-23,1100,20220604,1000,100
松屋,山梨県,松屋 富士吉田店,山梨県富士吉田市上吉田4203-3,1100,20220604,960,140
松屋,静岡県,松屋 富士宮店,静岡県富士宮市中原町312,1100,20220604,1000,100
松屋,広島県,松屋 福山花園店,広島県福山市花園町2-5-34,980,20220604,930,50
松屋,広島県,松屋 福山東店,広島県福山市東深津町3-23-8,980,20220604,930,50
松屋,神奈川,松屋 淵野辺店,神奈川県相模原市中央区鹿沼台2-18-6,1100,20220604,1040,60
松屋,神奈川,松屋 本厚木店,神奈川県厚木市中町2-4-16 トキワヤビル1F,1100,20220604,1040,60
松屋,神奈川,松屋 本厚木南口店,神奈川県厚木市旭町1-1-2 ケンタクビル1F,1100,20220604,1040,60
松屋,千葉県,松屋 末広街道店,千葉県千葉市中央区末広2-3-4,1050,20220604,1000,50
すき家,宮城県,すき家 286号仙台山田店,宮城県仙台市太白区山田字汚田通17-1,950,20220604,930,20
すき家,北海道,すき家 44号釧路木場店,北海道釧路郡釧路町木場1-3-3,950,20220604,900,50
すき家,宮城県,すき家 4号仙台泉ヶ丘店,宮城県仙台市泉区泉ヶ丘3-13-24,950,20220604,930,20
すき家,山形県,すき家 7号酒田北新橋店,山形県酒田市北新橋1-19-1,960,20220604,930,30
すき家,岩手県,すき家 一関山目店,岩手県一関市山目字寺前46-1,980,20220604,930,50
すき家,神奈川,すき家 横浜羽衣町店,神奈川県横浜市中区羽衣町2-8-5ホテルα-1横浜関内1F,1180,20220604,1140,40
すき家,神奈川,すき家 横浜山下町店,神奈川県横浜市中区山下町195-3,1180,20220604,1140,40
すき家,神奈川,すき家 横浜南幸二丁目店,神奈川県横浜市西区南幸2-9-16第8浅川ビル1F,1200,20220604,1140,60
すき家,神奈川,すき家 関内店,神奈川県横浜市中区翁町1-4-14浜吉ビル1F,1180,20220604,1140,40
すき家,北海道,すき家 釧路桜ヶ岡店,北海道釧路市桜ヶ岡1-9-21,950,20220604,900,50
すき家,神奈川,すき家 汐入店,神奈川県横浜市鶴見区仲通1-54アネックスつるみ102,1160,20220604,1140,20
すき家,山形県,すき家 酒田若竹店,山形県酒田市若竹町2-3-5,960,20220604,930,30
すき家,神奈川,すき家 尻手駅前店,神奈川県川崎市幸区南幸町3-109-1,1160,20220604,1140,20
すき家,東京都,すき家 新宿NSビル店,東京都新宿区西新宿2-4-1新宿NSビル1F,1300,20220604,1200,100
すき家,東京都,すき家 新宿御苑前駅店,東京都新宿区新宿1-19-7新花ビル1F,1200,20220604,1150,50
すき家,東京都,すき家 新宿南店,東京都新宿区新宿3-32-2,1200,20220604,1150,50
すき家,東京都,すき家 新宿二丁目店,東京都新宿区新宿2-15-15新宿ヤマトビル1F,1200,20220604,1150,50
すき家,神奈川,すき家 鶴見豊岡町店,神奈川県横浜市鶴見区豊岡町40-20,1160,20220604,1140,20
すき家,神奈川,すき家 都筑ふれあいの丘店,神奈川県横浜市都筑区荏田南1-1,1200,20220604,1140,60
すき家,秋田県,すき家 能代南BP店,秋田県能代市字寿域長根42-22,1000,20220604,930,70
すき家,東京都,すき家 府中店,東京都府中市宮西町2-21F,1120,20220604,1080,40
すき家,神奈川,すき家 保土ヶ谷今井店,神奈川県横浜市保土ヶ谷区今井町600-1,1140,20220604,1100,40
すき家,神奈川,すき家 本牧店,神奈川県横浜市中区本牧町2-364,1160,20220604,1140,20
