松屋,大阪府,松のや 貝塚店,大阪府貝塚市小瀬1-28-13,1040,20230114,1030,10
松屋,大阪府,松のや 萱島店/マイカリー食堂 萱島店,大阪府寝屋川市萱島本町19-11,1040,20230114,1023,17
松屋,大阪府,松のや 金岡店,大阪府堺市北区金岡町192-1 Pモール,1040,20230114,1030,10
松屋,大阪府,松のや 香里園店/マイカリー食堂 香里園店,大阪府寝屋川市香里南之町30-14,1040,20230114,1023,17
松屋,大阪府,松のや 高槻千代田町店,大阪府高槻市千代田町4-5,1040,20230114,1023,17
松屋,大阪府,松のや 今福鶴見店,大阪府大阪市鶴見区鶴見4-1-31,1040,20230114,1030,10
松屋,大阪府,松のや 堺東店/マイカリー食堂 堺東店,大阪府堺市堺区中瓦町2-3-12 きくやビル1階,1040,20230114,1030,10
松屋,大阪府,松のや 小阪店,大阪府東大阪市御厨栄町2-17-9,1040,20230114,1030,10
松屋,大阪府,松のや 少路店,大阪府豊中市少路1-2-1,1040,20230114,1030,10
松屋,京都府,松のや 松井山手店,京都府京田辺市山手西2-1-1,1000,20230114,980,20
松屋,大阪府,松のや 松原店,大阪府松原市上田8-14-13,1040,20230114,1030,10
松屋,大阪府,松のや 深江橋店,大阪府大阪市城東区諏訪4-3-1 ロイヤル・プラザ1F,1040,20230114,1030,10
松屋,大阪府,松のや 石橋店,大阪府池田市石橋1-3-10 MKビル1F,1040,20230114,1030,10
松屋,大阪府,松のや 池田店,大阪府池田市城南1-9-16,1040,20230114,1030,10
松屋,大阪府,松のや 藤阪店,大阪府枚方市津田北町1-3189-2,1040,20230114,1023,17
松屋,大阪府,松のや 瓢箪山店,大阪府東大阪市若草町5-2,1040,20230114,1030,10
松屋,大阪府,松のや 服部店,大阪府豊中市服部西町5-18-2,1040,20230114,1030,10
松屋,大阪府,松のや 野崎店/マイカリー食堂 野崎店,大阪府大東市南津の辺町21-40,1040,20230114,1023,17
松屋,兵庫県,松屋 JR尼崎店,兵庫県尼崎市長洲本通1-4-2 レジュールアッシュ尼崎駅前,1060,20230114,1000,60
松屋,大阪府,松屋 阿倍野店,大阪府大阪市阿倍野区阿倍野筋2-4-49,1070,20230114,1050,20
松屋,東京都,松屋 綾瀬店,東京都足立区綾瀬3-2-8,1200,20230114,1100,100
松屋,兵庫県,松屋 伊丹店,兵庫県伊丹市南町3-1-3,1030,20230114,1000,30
松屋,愛知県,松屋 一宮店,愛知県一宮市赤見1-2-4,1100,20230114,1050,50
松屋,大阪府,松屋 岡町店,大阪府豊中市中桜塚1-1-1ティオ阪急岡町1階,1060,20230114,1050,10
松屋,東京都,松屋 下石神井店/マイカリー食堂 下石神井店,東京都練馬区下石神井4-1-7MSビル1F,1150,20230114,1100,50
松屋,大阪府,松屋 花園町店,大阪府大阪市西成区鶴見橋1-3-5 ピュアファースト花園1F,1070,20230114,1050,20
松屋,東京都,松屋 蒲田西口店/マイカリー食堂 蒲田西口店,東京都大田区西蒲田7-1-11,1200,20230114,1150,50
松屋,東京都,松屋 蒲田東口店,東京都大田区蒲田5-25-2 コーポ橋本1F,1200,20230114,1150,50
松屋,大阪府,松屋 関大前店,大阪府吹田市千里山東1-14-5 吉本マンション1F,1050,20230114,1030,20
松屋,大阪府,松屋 岸里店,大阪府大阪市西成区潮路1-10-1 林 岸里駅前ビル,1050,20230114,1030,20
松屋,大阪府,松屋 喜連瓜破店,大阪府大阪市平野区喜連2-5-47 村瀬ビル1F,1050,20230114,1030,20
松屋,愛知県,松屋 亀島店,愛知県名古屋市中村区則武本通1-36 マシュービル1F,1100,20230114,1060,40
松屋,大阪府,松屋 京阪京橋店,大阪府大阪市都島区東野田町2-4-14,1150,20230114,1050,100
松屋,東京都,松屋 五反野店/マイカリー食堂 五反野店,東京都足立区足立4-29-8 重沢ビル1F,1200,20230114,1100,100
松屋,大阪府,松屋 御崎店,大阪府大阪市住之江区御崎7-15-21,1050,20230114,1030,20
松屋,大阪府,松屋 江坂駅前店,大阪府吹田市豊津町14-31由谷エムワイビル,1120,20230114,1100,20
松屋,愛知県,松屋 江南店,愛知県江南市高屋町西町112,1100,20230114,1050,50
松屋,大阪府,松屋 高槻市駅前店,大阪府高槻市城北町2-2-7,1100,20230114,1050,50
松屋,大阪府,松屋 高槻南口店,大阪府高槻市高槻町9-22 吉廣第二ビル 1.2F,1100,20230114,1050,50
松屋,大阪府,松屋 桜橋店,大阪府大阪市北区曽根崎新地2丁目2-13,1200,20230114,1100,100
松屋,大阪府,松屋 三国店,大阪府大阪市淀川区三国本町3-30-13,1100,20230114,1050,50
松屋,鹿児島,松屋 鹿児島新栄店/松のや 鹿児島新栄店/マイカリー食堂 鹿児島新栄店,鹿児島県鹿児島市新栄町185番106,1000,20230114,950,50
松屋,大阪府,松屋 守口市駅前店,大阪府守口市桜町9-8,1050,20230114,1030,20
松屋,東京都,松屋 秋葉原店,東京都千代田区神田松永町1番地,1250,20230114,1200,50
松屋,大阪府,松屋 住道店,大阪府大東市浜町9-10 住道駅前ビル,1050,20230114,1030,20
松屋,大阪府,松屋 住之江公園店,大阪府大阪市住之江区新北島1-1-7 ビックドックプラザ1F,1050,20230114,1030,20
松屋,大阪府,松屋 十三西口店,大阪府大阪市淀川区十三本町1-4-1,1100,20230114,1050,50
松屋,大阪府,松屋 十三東口店,大阪府大阪市淀川区十三東2-8-15,1100,20230114,1050,50
松屋,愛知県,松屋 小牧店,愛知県小牧市小木東1-146,1100,20230114,1050,50
松屋,大阪府,松屋 庄内店,大阪府豊中市庄内西町2-22-10幸栄ビル1F,1070,20230114,1050,20
松屋,大阪府,松屋 上新庄店,大阪府大阪市東淀川区瑞光1-11-29 新高ビル1階,1100,20230114,1050,50
松屋,東京都,松屋 新井薬師前店/マイカリー食堂 新井薬師前店,東京都中野区上高田3-40-10,1200,20230114,1100,100
松屋,東京都,松屋 新橋3丁目店,東京都港区新橋3-16-1,1250,20230114,1200,50
松屋,大阪府,松屋 新大阪東口店,大阪府大阪市東淀川区東中島1-20-9 新大阪池永ビル,1120,20230114,1050,70
松屋,大阪府,松屋 森ノ宮店,大阪府大阪市中央区森ノ宮中央1-2-24,1100,20230114,1050,50
松屋,大阪府,松屋 深江橋店,大阪府大阪市東成区深江北2-9-24 コルタ深江橋,1050,20230114,1030,20
松屋,大阪府,松屋 針中野店,大阪府大阪市東住吉区駒川5-16-3 1.2F,1050,20230114,1030,20
松屋,東京都,松屋 西蒲田店,東京都大田区西蒲田8-24-8,1200,20230114,1100,100
松屋,東京都,松屋 西新井店,東京都足立区西新井栄町2-3-2,1200,20230114,1100,100
松屋,大阪府,松屋 西中島店,大阪府大阪市淀川区西中島6-7-3,1100,20230114,1050,50
松屋,東京都,松屋 青砥店,東京都葛飾区青戸3-37-19,1200,20230114,1100,100
松屋,大阪府,松屋 石橋駅前店,大阪府池田市石橋1-10-27,1050,20230114,1030,20
松屋,大阪府,松屋 千林大宮店,大阪府大阪市旭区森小路2-6-1,1050,20230114,1030,20
松屋,兵庫県,松屋 川西能勢口店/マイカリー食堂 川西能勢口店,兵庫県川西市栄町10-5パルティ川西101号,1030,20230114,1000,30
松屋,大阪府,松屋 船場心斎橋店,大阪府大阪市中央区北久宝寺町3-6-10クマタカ第一ビル1・2階,1100,20230114,1060,40
松屋,大阪府,松屋 曽根店,大阪府豊中市曽根東町2-12-14,1060,20230114,1030,30
松屋,東京都,松屋 足立江北店,東京都足立区江北3丁目35番12号,1200,20230114,1100,100
松屋,東京都,松屋 足立保塚店,東京都足立区保塚町12-21,1200,20230114,1100,100
松屋,大阪府,松屋 大国町店,大阪府大阪市浪速区敷津東1-9-16,1070,20230114,1050,20
松屋,大阪府,松屋 大阪茨木店,大阪府茨木市春日1-4-1,1100,20230114,1050,50
松屋,大阪府,松屋 大阪本町店,大阪府大阪市中央区南本町3-3-8,1100,20230114,1060,40
松屋,大阪府,松屋 大阪野田店,大阪府大阪市福島区吉野3-12-27,1120,20230114,1080,40
松屋,東京都,松屋 大森町店,東京都大田区大森西3-20-14,1200,20230114,1100,100
松屋,東京都,松屋 大鳥居店,東京都大田区萩中3-6-5,1200,20230114,1100,100
松屋,大阪府,松屋 大東御供田店,大阪府大東市御供田3-7-41,1050,20230114,1030,20
松屋,東京都,松屋 池上3丁目店,東京都大田区池上3-3-1,1200,20230114,1100,100
松屋,東京都,松屋 池上店,東京都大田区池上6-2-17,1200,20230114,1100,100
松屋,東京都,松屋 竹ノ塚店,東京都足立区竹の塚6-9-2 第7丸本ビル,1200,20230114,1100,100
松屋,大阪府,松屋 中崎町店,大阪府大阪市北区中崎1-6-15 中崎1丁目くさかビル1・2F,1150,20230114,1060,90
松屋,東京都,松屋 町屋店,東京都荒川区町屋1-2-10,1200,20230114,1100,100
松屋,大阪府,松屋 長居店,大阪府大阪市住吉区長居3-14-8,1050,20230114,1030,20
松屋,大阪府,松屋 鳥飼店,大阪府摂津市鳥飼本町3-16-59,1100,20230114,1050,50
松屋,大阪府,松屋 通天閣店,大阪府大阪市浪速区恵美須西2-1-32,1070,20230114,1050,20
松屋,大阪府,松屋 天神橋六丁目店,大阪府大阪市北区本庄東1-6-22,1200,20230114,1100,100
松屋,大阪府,松屋 天満橋店,大阪府大阪市中央区谷町2-8-1大手前M2ビル,1100,20230114,1050,50
松屋,大阪府,松屋 東住吉中野店,大阪府大阪市東住吉区中野4-3-22,1050,20230114,1030,20
松屋,大阪府,松屋 東住吉湯里店,大阪府大阪市東住吉区湯里5-20-6,1050,20230114,1030,20
松屋,大阪府,松屋 東淀川菅原店,大阪府大阪市東淀川区菅原2-7-9,1100,20230114,1050,50
松屋,大阪府,松屋 南茨木店,大阪府茨木市沢良宜西1-2-20,1100,20230114,1050,50
松屋,大阪府,松屋 南森町駅前店,大阪府大阪市北区天神橋2丁目北1-3,1120,20230114,1080,40
松屋,大阪府,松屋 南津守店,大阪府大阪市西成区南津守6-6-46,1050,20230114,1030,20
松屋,大阪府,松屋 南方店/マイカリー食堂 南方店,大阪府大阪市淀川区西中島3-17-2,1100,20230114,1050,50
松屋,兵庫県,松屋 尼崎アマドゥ店,兵庫県尼崎市道意町7-1,1030,20230114,1000,30
松屋,兵庫県,松屋 尼崎潮江店,兵庫県尼崎市潮江1-27-15,1060,20230114,1000,60
松屋,兵庫県,松屋 尼崎店,兵庫県尼崎市神田中通2-17,1060,20230114,1000,60
松屋,大阪府,松屋 忍ヶ丘駅前店/松のや 忍ヶ丘駅前店,大阪府四條畷市岡山東1丁目-2-15,1100,20230114,1050,50
松屋,東京都,松屋 梅屋敷店,東京都大田区蒲田2-4-5 スカイドムス,1200,20230114,1100,100
松屋,大阪府,松屋 梅田角田町店,大阪府大阪市北区角田町6-5,1200,20230114,1100,100
松屋,大阪府,松屋 梅田神山町店,大阪府大阪市北区神山町8-22 梅電ビル,1200,20230114,1100,100
松屋,大阪府,松屋 肥後橋店,大阪府大阪市西区江戸堀1-2-14 肥後橋官報ビル,1150,20230114,1100,50
松屋,大阪府,松屋 富田店,大阪府高槻市富田町1-6-3,1100,20230114,1050,50
松屋,兵庫県,松屋 武庫川店/マイカリー食堂 武庫川店,兵庫県尼崎市稲葉荘1-14-5,1030,20230114,1000,30
松屋,東京都,松屋 武蔵新田店,東京都大田区矢口1-7-15イセモトビル,1200,20230114,1100,100
松屋,東京都,松屋 平和島店,東京都大田区大森北6-13-10 島田ビル,1200,20230114,1100,100
松屋,兵庫県,松屋 宝塚安倉店,兵庫県宝塚市安倉南2-2-21,1030,20230114,1000,30
松屋,大阪府,松屋 放出店,大阪府大阪市鶴見区今津南1-7-29,1050,20230114,1030,20
松屋,愛知県,松屋 豊山店,愛知県西春日井郡豊山町大字豊場字栄81,1100,20230114,1050,50
松屋,大阪府,松屋 豊中熊野町店/マイカリー食堂 豊中熊野町店,大阪府豊中市熊野町1-1-8,1060,20230114,1030,30
松屋,大阪府,松屋 豊中上津島店,大阪府豊中市上津島3-11-25,1060,20230114,1030,30
松屋,東京都,松屋 北綾瀬店/マイカリー食堂 北綾瀬店,東京都足立区加平1-22-11,1200,20230114,1100,100
松屋,東京都,松屋 北千住店/マイカリー食堂 北千住店,東京都足立区千住2-61,1200,20230114,1100,100
松屋,東京都,松屋 北千住東口店,東京都足立区千住旭町40-23 第3三和ビル,1200,20230114,1100,100
松屋,大阪府,松屋 箕面店/マイカリー食堂 箕面店,大阪府箕面市半町3-14-20,1050,20230114,1030,20
松屋,大阪府,松屋 淀屋橋店,大阪府大阪市中央区北浜3-2-25 京阪淀屋橋ビル,1150,20230114,1100,50
