松屋,埼玉県,すし松 エキアプレミエ和光市駅店,埼玉県和光市本町4-7,1200,20230923,1300,-100
松屋,神奈川,すし松 鶴見東口店/松のや 鶴見東口店,神奈川県横浜市鶴見区鶴見中央1-3-3,1250,20230923,1450,-200
松屋,兵庫県,松のや 川西能勢口店/マイカリー食堂 川西能勢口店,兵庫県川西市栄町21-25 ストーク田口1F,1040,20230923,1340,-300
松屋,兵庫県,松のや 武庫之荘店,兵庫県尼崎市南武庫之荘1-14-1 森陽ビル1F,1040,20230923,1100,-60
松屋,東京都,松屋 下板橋店,東京都豊島区池袋本町3-25-13,1150,20230923,1200,-50
松屋,千葉県,松屋 松戸古ヶ崎店/松のや 松戸古ヶ崎店,千葉県松戸市古ヶ崎1丁目3056,1200,20230923,1300,-100
松屋,千葉県,松屋 成田空港第3ターミナル店,千葉県成田市取香148-1,1200,20230923,1300,-100
松屋,東京都,松屋 中板橋店,東京都板橋区中板橋21-2,1150,20230923,1200,-50
松屋,東京都,松屋 板橋区役所前店,東京都板橋区板橋2-61-11 ホシカメビル1F,1200,20230923,1250,-50
松屋,東京都,松屋 板橋店,東京都板橋区板橋1-50-1,1200,20230923,1250,-50
松屋,東京都,松屋 板橋本町店,東京都板橋区本町36-1 バロール本町1F,1200,20230923,1250,-50
松屋,和歌山,松屋 有田インター店/松のや 有田インター店,和歌山県有田郡有田川町天満161-2,1000,20230923,1100,-100
すき家,秋田県,すき家 105号大仙北長野店,秋田県大仙市北長野字道ノ下117-1,900,20230923,950,-50
すき家,長野県,すき家 117号飯山店,長野県飯山市静間2085-1,1000,20230923,1030,-30
すき家,茨城県,すき家 118号常陸大宮泉店,茨城県常陸大宮市泉字中村田462-6,1000,20230923,1050,-50
すき家,神奈川,すき家 129号厚木山際店,神奈川県厚木市山際281-1,1090,20230923,1150,-60
すき家,神奈川,すき家 129号平塚四之宮店,神奈川県平塚市東真土2-5-53,1090,20230923,1150,-60
すき家,北海道,すき家 12号岩見沢店,北海道岩見沢市九条西10-1-39,960,20230923,1000,-40
すき家,北海道,すき家 12号江別野幌店,北海道江別市野幌町48-4,960,20230923,1000,-40
すき家,北海道,すき家 12号滝川東町店,北海道滝川市東町2-42-7,1000,20230923,1020,-20
すき家,北海道,すき家 12号美唄店,北海道美唄市大通東一条南6丁目1-1,960,20230923,1000,-40
すき家,神奈川,すき家 134号横須賀池田店,神奈川県横須賀市池田町5-14-12,1090,20230923,1130,-40
すき家,静岡県,すき家 135号下田店,静岡県下田市柿崎字間戸浜6-22,1100,20230923,1200,-100
すき家,静岡県,すき家 136号伊豆の国大仁店,静岡県伊豆の国市吉田363-4,1030,20230923,1080,-50
すき家,静岡県,すき家 136号三島店,静岡県三島市安久146-3,1030,20230923,1050,-20
すき家,山梨県,すき家 139号都留桂店,山梨県都留市桂町876-1,950,20230923,1000,-50
すき家,山形県,すき家 13号尾花沢店,山形県尾花沢市大字尾花沢下新田1731-2,930,20230923,950,-20
すき家,長野県,すき家 152号茅野店,長野県茅野市本町東5291-1,1000,20230923,1030,-30
すき家,長野県,すき家 153号伊那店,長野県伊那市山寺282-1,1000,20230923,1050,-50
すき家,長野県,すき家 153号飯田IC店,長野県飯田市上殿岡576-1,1030,20230923,1080,-50
すき家,石川県,すき家 159号かほく店,石川県かほく市内日角6-1-1,1000,20230923,1050,-50
すき家,大阪府,すき家 163号門真殿島店,大阪府門真市殿島町7-13,1050,20230923,1100,-50
すき家,神奈川,すき家 16号横須賀安浦店,神奈川県横須賀市安浦町3-24-3,1120,20230923,1130,-10
すき家,埼玉県,すき家 16号見沼深作店,埼玉県さいたま市見沼区深作2-29-14,1050,20230923,1100,-50
すき家,埼玉県,すき家 16号上尾瓦葺店,埼玉県上尾市瓦葺708-1,1050,20230923,1100,-50
すき家,神奈川,すき家 16号相模原橋本店,神奈川県相模原市緑区橋本2-22-18,1090,20230923,1120,-30
すき家,大阪府,すき家 170号羽曳野西浦店,大阪府羽曳野市西浦3-2-1,1050,20230923,1100,-50
すき家,大阪府,すき家 170号熊取店,大阪府泉南郡熊取町紺屋2-5-5,1050,20230923,1100,-50
すき家,大阪府,すき家 170号寝屋川高宮店,大阪府寝屋川市高宮1-10-27,1050,20230923,1100,-50
すき家,大阪府,すき家 171号箕面今宮店,大阪府箕面市今宮2-3-1,1050,20230923,1100,-50
すき家,大阪府,すき家 171号箕面牧落店,大阪府箕面市牧落3-20-30,1050,20230923,1100,-50
すき家,新潟県,すき家 17号魚沼店,新潟県魚沼市井口新田277-1,960,20230923,1030,-70
すき家,群馬県,すき家 17号沼田店,群馬県沼田市硯田町590-5,1000,20230923,1080,-80
すき家,埼玉県,すき家 17号本庄店,埼玉県本庄市本庄4-7-11,1050,20230923,1080,-30
すき家,長野県,すき家 19号塩尻広丘店,長野県塩尻市広丘野村1503-1,1000,20230923,1050,-50
すき家,長野県,すき家 19号松本高宮店,長野県松本市高宮東1-25,1030,20230923,1050,-20
すき家,長野県,すき家 19号松本村井店,長野県松本市村井町北2-8-45,1030,20230923,1050,-20
すき家,神奈川,すき家 1国茅ヶ崎十間坂店,神奈川県茅ヶ崎市十間坂3-2-2,1100,20230923,1130,-30
すき家,静岡県,すき家 1国三島谷田店,静岡県三島市谷田60-1,1030,20230923,1080,-50
すき家,大阪府,すき家 1国城東関目店,大阪府大阪市城東区関目5-3-3,1050,20230923,1100,-50
すき家,神奈川,すき家 1国藤沢辻堂店,神奈川県藤沢市辻堂神台2-8-17,1100,20230923,1150,-50
すき家,大阪府,すき家 1国枚方北中振店,大阪府枚方市北中振4-10-5,1050,20230923,1100,-50
すき家,福岡県,すき家 202号福岡周船寺店,福岡県福岡市西区周船寺1-13-8,930,20230923,950,-20
すき家,山梨県,すき家 20号甲斐竜王店,山梨県甲斐市富竹新田1279-1,1000,20230923,1050,-50
すき家,山梨県,すき家 20号甲府向町店,山梨県甲府市向町729-1,1000,20230923,1030,-30
すき家,山梨県,すき家 20号笛吹一宮店,山梨県笛吹市一宮町東原25-1,1000,20230923,1030,-30
すき家,北海道,すき家 228号北斗七重浜店,北海道北斗市七重浜7-2-1,980,20230923,1000,-20
すき家,北海道,すき家 231号留萌店,北海道留萌市旭町2-1-1,960,20230923,1000,-40
すき家,北海道,すき家 235号静内店,北海道日高郡新ひだか町静内末広町2-1-20,1000,20230923,1040,-40
すき家,北海道,すき家 238号紋別店,北海道紋別市落石町4-13-13,1130,20230923,1200,-70
すき家,神奈川,すき家 246号伊勢原白根店,神奈川県伊勢原市白根95-1,1090,20230923,1130,-40
すき家,神奈川,すき家 246号秦野渋沢店,神奈川県秦野市並木町188-1,1090,20230923,1130,-40
すき家,埼玉県,すき家 254号本庄児玉店,埼玉県本庄市児玉町吉田林397-3,1050,20230923,1080,-30
すき家,神奈川,すき家 255号小田原成田店,神奈川県小田原市成田408-1,1110,20230923,1180,-70
すき家,神奈川,すき家 255号大井松田店,神奈川県足柄上郡大井町金子1627-1,1110,20230923,1180,-70
すき家,大阪府,すき家 25号八尾永畑店,大阪府八尾市永畑町1-2-58,1050,20230923,1100,-50
すき家,大阪府,すき家 25号平野加美西店,大阪府大阪市平野区加美西1-6-16,1050,20230923,1100,-50
すき家,福岡県,すき家 263号福岡野芥店,福岡県福岡市早良区野芥4-45-5,950,20230923,980,-30
すき家,大阪府,すき家 26号岸和田下池田店,大阪府岸和田市下池田町1-2-3,1050,20230923,1100,-50
すき家,大阪府,すき家 26号高石店,大阪府高石市西取石7-11-1,1050,20230923,1100,-50
すき家,大阪府,すき家 26号堺山本店,大阪府堺市堺区山本町3-78,1050,20230923,1100,-50
すき家,大阪府,すき家 26号西住之江店,大阪府大阪市住之江区西住之江1-9-21,1050,20230923,1100,-50
すき家,大阪府,すき家 26号泉佐野鶴原店,大阪府泉佐野市鶴原1855-3,1050,20230923,1100,-50
すき家,大阪府,すき家 26号泉大津店,大阪府泉大津市北豊中町2-17-24,1050,20230923,1100,-50
すき家,岩手県,すき家 283号遠野店,岩手県遠野市早瀬町4-7-36,950,20230923,970,-20
すき家,福島県,すき家 288号田村店,福島県田村市船引町船引字舘柄前89-1,950,20230923,980,-30
すき家,長野県,すき家 292号中野店,長野県中野市一本木319-3,1000,20230923,1030,-30
すき家,石川県,すき家 305号小松今江店,石川県小松市今江町3-700,1030,20230923,1050,-20
すき家,大阪府,すき家 307号枚方津田西店,大阪府枚方市津田西町1-2-1,1050,20230923,1100,-50
すき家,大阪府,すき家 309号堺黒山店,大阪府堺市美原区黒山168-1,1050,20230923,1100,-50
すき家,大阪府,すき家 310号堺大野芝店,大阪府堺市中区大野芝町209-1,1050,20230923,1100,-50
すき家,大阪府,すき家 310号大阪狭山店,大阪府大阪狭山市東茱萸木1-691-1,1050,20230923,1100,-50
すき家,群馬県,すき家 354号邑楽店,群馬県邑楽郡邑楽町狸塚字高原357-1,1000,20230923,1050,-50
すき家,北海道,すき家 36号清田里塚店,北海道札幌市清田区里塚一条3-2-10,1000,20230923,1020,-20
すき家,北海道,すき家 36号苫小牧日吉店,北海道苫小牧市日吉町1-1-5,960,20230923,1020,-60
すき家,北海道,すき家 36号苫小牧明野店,北海道苫小牧市明野新町2-1-4,1000,20230923,1020,-20
すき家,秋田県,すき家 398号湯沢沖鶴店,秋田県湯沢市沖鶴234-1,900,20230923,950,-50
すき家,北海道,すき家 39号北見三輪店,北海道北見市東三輪2-831-4,1000,20230923,1020,-20
すき家,北海道,すき家 39号北見大町店,北海道北見市大町21-1,980,20230923,1000,-20
すき家,北海道,すき家 39号網走新町店,北海道網走市新町2-3-5,1000,20230923,1050,-50
すき家,新潟県,すき家 403号加茂店,新潟県加茂市番田5-20,950,20230923,1000,-50
すき家,北海道,すき家 40号稚内大黒店,北海道稚内市大黒2-6-24,1150,20230923,1300,-150
すき家,北海道,すき家 40号名寄店,北海道名寄市西四条南10-56-1,960,20230923,1000,-40
すき家,神奈川,すき家 412号厚木中荻野店,神奈川県厚木市中荻野580-1,1090,20230923,1120,-30
すき家,神奈川,すき家 412号厚木林店,神奈川県厚木市林4-12-34,1090,20230923,1130,-40
すき家,神奈川,すき家 413号津久井三ケ木店,神奈川県相模原市緑区三ケ木405-1,1090,20230923,1130,-40
すき家,静岡県,すき家 414号沼津三枚橋店,静岡県沼津市三枚橋町10-1,1030,20230923,1080,-50
すき家,富山県,すき家 41号大沢野店,富山県富山市上大久保1052-1,1030,20230923,1080,-50
すき家,和歌山,すき家 42号新宮神倉店,和歌山県新宮市神倉3-1291-1,1050,20230923,1100,-50
すき家,北海道,すき家 44号根室店,北海道根室市西浜町8-92-1,1000,20230923,1020,-20
すき家,青森県,すき家 45号おいらせ店,青森県上北郡おいらせ町菜飯52-4,950,20230923,980,-30
すき家,青森県,すき家 45号八戸城下店,青森県八戸市城下4-14-14,920,20230923,950,-30
すき家,青森県,すき家 45号八戸類家店,青森県八戸市類家5-11-5,920,20230923,940,-20
すき家,栃木県,すき家 461号大田原美原店,栃木県大田原市美原1-1-6,980,20230923,1000,-20
すき家,神奈川,すき家 467号藤沢長後店,神奈川県藤沢市長後754-1,1100,20230923,1130,-30
すき家,新潟県,すき家 49号阿賀野水原店,新潟県阿賀野市庄ヶ宮679-1,950,20230923,1000,-50
すき家,埼玉県,すき家 4号越谷大間野店,埼玉県越谷市大間野町2-207-4,1050,20230923,1100,-50
すき家,埼玉県,すき家 4号春日部備後店,埼玉県春日部市備後東5-11-17,1050,20230923,1100,-50
すき家,埼玉県,すき家 4号杉戸堤根店,埼玉県北葛飾郡杉戸町堤根4024-1,1050,20230923,1100,-50
すき家,岩手県,すき家 4号二戸店,岩手県二戸市米沢字下村6-1,900,20230923,960,-60
すき家,栃木県,すき家 4号矢板店,栃木県矢板市中691-1,980,20230923,1000,-20
すき家,茨城県,すき家 51号水戸大洗IC店,茨城県水戸市大串町965-3,1000,20230923,1050,-50
すき家,山梨県,すき家 52号甲府宝店,山梨県甲府市宝2-25-8,1000,20230923,1030,-30
すき家,北海道,すき家 5号函館亀田店,北海道函館市亀田町17-11,980,20230923,1000,-20
すき家,茨城県,すき家 6号水戸住吉店,茨城県水戸市住吉町47-1,1000,20230923,1050,-50
すき家,青森県,すき家 7号弘前高崎店,青森県弘前市大字高崎字広田115-2,920,20230923,950,-30
すき家,山形県,すき家 7号酒田こあら店,山形県酒田市こあら二丁目1-1,1080,20230923,1100,-20
すき家,秋田県,すき家 7号秋田土崎店,秋田県秋田市土崎港相染町字大谷地36-4,930,20230923,960,-30
すき家,新潟県,すき家 7号新発田中曽根店,新潟県新発田市中曽根町3-10-12,950,20230923,1000,-50
すき家,新潟県,すき家 7号胎内店,新潟県胎内市大川町15-33,950,20230923,1000,-50
すき家,秋田県,すき家 7号大館店,秋田県大館市根下戸新町9-25,950,20230923,970,-20
すき家,石川県,すき家 8号加賀加茂店,石川県加賀市加茂町チ65-1,1030,20230923,1050,-20
すき家,富山県,すき家 8号高岡北島店,富山県高岡市北島婦計459-2,1050,20230923,1080,-30
すき家,新潟県,すき家 8号糸魚川寺島店,新潟県糸魚川市寺島3-2-34,1000,20230923,1030,-30
すき家,新潟県,すき家 8号上越下荒浜店,新潟県上越市大字下荒浜字大谷内横田346-1,1000,20230923,1030,-30
すき家,兵庫県,すき家 JR神戸駅北店,兵庫県神戸市中央区多聞通2-4-4神戸ブックローンビル東館1F,1030,20230923,1050,-20
すき家,大阪府,すき家 なんば楽座店,大阪府大阪市中央区難波4-3-19,1120,20230923,1180,-60
すき家,大阪府,すき家 なんば千日前店,大阪府大阪市中央区難波千日前11-20遊企画ビル1階,1120,20230923,1200,-80
すき家,大阪府,すき家 はびきの伊賀店,大阪府羽曳野市伊賀4-5-6,1050,20230923,1100,-50
すき家,神奈川,すき家 アクロスプラザ湯河原店,神奈川県足柄下郡湯河原町中央1-1617-54,1090,20230923,1180,-90
すき家,茨城県,すき家 イーアスつくば店,茨城県つくば市研究学園5-19イーアスつくばショッピングセンター3F,1000,20230923,1050,-50
すき家,北海道,すき家 イオンモール旭川西店,北海道旭川市緑町23-2161-3,1000,20230923,1020,-20
すき家,大阪府,すき家 イオンモール茨木店,大阪府茨木市松ヶ本町8-30-3イオン茨木店1F,1050,20230923,1100,-50
すき家,新潟県,すき家 イオンモール新潟南店,新潟県新潟市江南区下早通柳田1-1-1,1000,20230923,1030,-30
すき家,北海道,すき家 イオンモール発寒店,北海道札幌市西区発寒八条12-1-1,980,20230923,1000,-20
すき家,埼玉県,すき家 イオンモール北戸田店,埼玉県戸田市美女木東1-3-1,1020,20230923,1080,-60
すき家,神奈川,すき家 イオン金沢八景店,神奈川県横浜市金沢区泥亀1-27-1イオン金沢八景地下1Fフードコート内,1090,20230923,1150,-60
すき家,神奈川,すき家 イオン秦野店,神奈川県秦野市入船町12-1,1090,20230923,1130,-40
すき家,埼玉県,すき家 イトーヨーカドー三郷店,埼玉県三郷市ピアラシティ1-1-1イトーヨーカドー三郷1F,1050,20230923,1100,-50
すき家,福島県,すき家 ザ・モール郡山店,福島県郡山市長者1-1-56,900,20230923,980,-80
すき家,山梨県,すき家 フォレストモール富士川店,山梨県南巨摩郡富士川町青柳町973-1,1000,20230923,1050,-50
すき家,大阪府,すき家 阿倍野店,大阪府大阪市阿倍野区阿倍野筋2-4-49アベニュ-ホ-ル1F,1050,20230923,1120,-70
すき家,北海道,すき家 旭川永山店,北海道旭川市永山六条5-77-54,1000,20230923,1020,-20
すき家,北海道,すき家 旭川神居店,北海道旭川市神居2条1-1-17,1000,20230923,1020,-20
すき家,北海道,すき家 旭川豊岡店,北海道旭川市豊岡十四条6-8-15,1000,20230923,1020,-20
すき家,神奈川,すき家 伊勢原桜台店,神奈川県伊勢原市桜台2-13-14,1090,20230923,1120,-30
すき家,兵庫県,すき家 伊丹瑞穂店,兵庫県伊丹市瑞穂町2-21,1030,20230923,1050,-20
すき家,兵庫県,すき家 伊丹野間店,兵庫県伊丹市南野北5-3-28,1030,20230923,1050,-20
すき家,静岡県,すき家 伊東桜木店,静岡県伊東市桜木町1-3-18,1030,20230923,1080,-50
すき家,大阪府,すき家 茨木IC店,大阪府茨木市郡4-11-36,1050,20230923,1100,-50
すき家,大阪府,すき家 茨木中穂積店,大阪府茨木市中穂積2-10-8,1050,20230923,1100,-50
すき家,石川県,すき家 羽咋石野町店,石川県羽咋市石野町イ54-1,1000,20230923,1080,-80
すき家,長野県,すき家 塩尻志学館高校前店,長野県塩尻市広丘高出1486-230,1000,20230923,1050,-50
すき家,秋田県,すき家 横手IC店,秋田県横手市安田向田173-3,930,20230923,960,-30
すき家,神奈川,すき家 横須賀中央店,神奈川県横須賀市若松町1-4味ビル1F,1090,20230923,1150,-60
すき家,神奈川,すき家 横須賀野比店,神奈川県横須賀市野比1-4-25,1090,20230923,1130,-40
すき家,神奈川,すき家 海老名河原口店,神奈川県海老名市河原口5-4-28,1150,20230923,1180,-30
すき家,神奈川,すき家 開成店,神奈川県足柄上郡開成町吉田島783-1,1090,20230923,1150,-60
すき家,大阪府,すき家 貝塚北町店,大阪府貝塚市北町17-15,1050,20230923,1100,-50
すき家,茨城県,すき家 笠間友部店,茨城県笠間市旭町427-2,1000,20230923,1050,-50
すき家,富山県,すき家 滑川柳原店,富山県滑川市柳原59-14,1030,20230923,1080,-50
すき家,大阪府,すき家 蒲生四丁目店,大阪府大阪市城東区蒲生4-21-8,1050,20230923,1100,-50
すき家,神奈川,すき家 釜利谷店,神奈川県横浜市金沢区釜利谷東4-53-11,1090,20230923,1130,-40
すき家,神奈川,すき家 寒川宮山店,神奈川県高座郡寒川町宮山3460-1,1090,20230923,1112,-22
すき家,神奈川,すき家 寒川田端店,神奈川県高座郡寒川町田端1445-1,1090,20230923,1112,-22
すき家,神奈川,すき家 環状4号泉区和泉店,神奈川県横浜市泉区下和泉1-4-3,1100,20230923,1150,-50
すき家,大阪府,すき家 関目店,大阪府大阪市城東区成育2-13-15アイビーマンション1F,1050,20230923,1100,-50
すき家,大阪府,すき家 岸和田磯上店,大阪府岸和田市磯上町4-23-25,1050,20230923,1100,-50
すき家,大阪府,すき家 岸和田和泉IC北店,大阪府岸和田市田治米町343-1,1050,20230923,1100,-50
すき家,埼玉県,すき家 岩槻駅前店,埼玉県さいたま市岩槻区本町1-3-3吉田ビル1F,1050,20230923,1100,-50
すき家,埼玉県,すき家 岩槻城北東店,埼玉県さいたま市岩槻区上野1-20-5,1050,20230923,1100,-50
すき家,新潟県,すき家 亀田店,新潟県新潟市江南区早苗2-248-1,950,20230923,1000,-50
すき家,埼玉県,すき家 吉川栄店,埼玉県吉川市栄834-1,1050,20230923,1080,-30
すき家,神奈川,すき家 京急久里浜駅前店,神奈川県横須賀市久里浜4-5-4,1090,20230923,1130,-40
すき家,大阪府,すき家 京阪枚方市駅前店,大阪府枚方市岡本町3-4N´sSquare1F,1050,20230923,1100,-50
すき家,大阪府,すき家 玉造駅前店,大阪府大阪市中央区玉造1-5-8大倉ビル,1050,20230923,1120,-70
すき家,大阪府,すき家 近畿大学店,大阪府東大阪市新上小阪5-86近畿大学Eキャンパス構内,1050,20230923,1100,-50
すき家,神奈川,すき家 戸塚南店,神奈川県横浜市戸塚区東俣野町1029-1,1100,20230923,1150,-50
すき家,新潟県,すき家 五泉東本町店,新潟県五泉市東本町2-78-1,950,20230923,980,-30
すき家,大阪府,すき家 交野星田北店,大阪府交野市星田北3-37-4,1050,20230923,1100,-50
すき家,青森県,すき家 弘前青山店,青森県弘前市大字青山5-28-1,900,20230923,930,-30
すき家,青森県,すき家 弘前中央店,青森県弘前市大字大町3-1-4,900,20230923,930,-30
すき家,青森県,すき家 弘前中野店,青森県弘前市中野2-1-6,900,20230923,920,-20
すき家,大阪府,すき家 江戸堀店,大阪府大阪市西区江戸堀1-24-15タツト・肥後橋ビル1F,1180,20230923,1200,-20
すき家,山梨県,すき家 甲州塩山店,山梨県甲州市塩山下於曽1559-1,1000,20230923,1030,-30
すき家,山梨県,すき家 甲斐島上条店,山梨県甲斐市島上条207-1,1000,20230923,1030,-30
すき家,山梨県,すき家 甲府アルプス通り店,山梨県中巨摩郡昭和町西条2707-1,1000,20230923,1050,-50
すき家,山梨県,すき家 甲府国玉店,山梨県甲府市国玉町975-1,1000,20230923,1030,-30
すき家,大阪府,すき家 香里園駅前店,大阪府寝屋川市香里南之町20-23,1050,20230923,1100,-50
すき家,大阪府,すき家 高槻下田部店,大阪府高槻市下田部町1-3-28,1050,20230923,1100,-50
すき家,大阪府,すき家 高槻古曽部店,大阪府高槻市古曽部町2-21-32,1050,20230923,1100,-50
すき家,栃木県,すき家 黒磯住吉店,栃木県那須塩原市住吉町77-12,980,20230923,1000,-20
すき家,大阪府,すき家 此花四貫島店,大阪府大阪市此花区四貫島2-4-5,1070,20230923,1120,-50
すき家,大阪府,すき家 阪急茨木市駅前店,大阪府茨木市双葉町8-1奥村ビル1F,1050,20230923,1100,-50
すき家,兵庫県,すき家 阪急園田駅前店,兵庫県尼崎市東園田町9-17-16メゾン・ドゥ・ファミリー1F,1060,20230923,1080,-20
すき家,大阪府,すき家 阪急庄内南店,大阪府豊中市庄内西町5-1-3,1060,20230923,1080,-20
すき家,大阪府,すき家 阪急淡路西口店,大阪府大阪市東淀川区淡路4-11-15井上ビル1F,1100,20230923,1120,-20
すき家,大阪府,すき家 阪神野田駅前店,大阪府大阪市福島区海老江1-1-17野田アプラ105,1120,20230923,1200,-80
すき家,大阪府,すき家 堺IC店,大阪府堺市南区小代457-1,1050,20230923,1100,-50
すき家,大阪府,すき家 堺筋本町店,大阪府大阪市中央区本町1-7-1三星本町ビル1F,1120,20230923,1200,-80
すき家,大阪府,すき家 堺高須店,大阪府堺市堺区高須町2-1-16,1050,20230923,1100,-50
すき家,大阪府,すき家 堺黒土店,大阪府堺市北区黒土町2355-1,1050,20230923,1100,-50
すき家,大阪府,すき家 堺津久野店,大阪府堺市西区下田町26-23,1050,20230923,1100,-50
すき家,大阪府,すき家 堺片蔵店,大阪府堺市南区片蔵1333-1,1050,20230923,1100,-50
すき家,大阪府,すき家 桜川駅前店,大阪府大阪市浪速区幸町2-8-8常盤機械ビル1F,1050,20230923,1120,-70
すき家,北海道,すき家 札幌ポールタウン店,北海道札幌市中央区南三条西3-10さっぽろ地下街ポールタウン,1000,20230923,1020,-20
すき家,北海道,すき家 札幌駅前通北一条店,北海道札幌市中央区北1条西3-2-5北尾ビル1F,1000,20230923,1020,-20
すき家,北海道,すき家 札幌桑園店,北海道札幌市中央区北十一条西20丁目1-10,1000,20230923,1020,-20
すき家,北海道,すき家 札幌山鼻店,北海道札幌市中央区南十三条西15-3-6,1000,20230923,1020,-20
すき家,北海道,すき家 札幌新道発寒店,北海道札幌市西区発寒12条1-2-30,1000,20230923,1020,-20
すき家,北海道,すき家 札幌石山通南一条店,北海道札幌市中央区南1条西11-327-27ジュピタープレイス1F,1000,20230923,1020,-20
すき家,北海道,すき家 札幌屯田店,北海道札幌市北区屯田六条4-4-20,1000,20230923,1020,-20
すき家,北海道,すき家 札幌美香保店,北海道札幌市東区北二十条東8-3-5,1000,20230923,1020,-20
すき家,北海道,すき家 札幌北33条店,北海道札幌市北区北三十三条西4-1-12,1000,20230923,1020,-20
すき家,北海道,すき家 札幌北郷店,北海道札幌市白石区北郷三条8-1-1,1000,20230923,1020,-20
すき家,北海道,すき家 札幌北野店,北海道札幌市清田区北野七条3-5-5,1000,20230923,1020,-20
すき家,兵庫県,すき家 三宮駅東店,兵庫県神戸市中央区雲井通6-1-15サンシティビル103,1060,20230923,1080,-20
すき家,兵庫県,すき家 三宮店,兵庫県神戸市中央区北長狭通1-20-2,1060,20230923,1080,-20
すき家,大阪府,すき家 三国本町店,大阪府大阪市淀川区三国本町2-13-14,1060,20230923,1100,-40
すき家,静岡県,すき家 三島徳倉店,静岡県三島市徳倉910-2,1030,20230923,1080,-50
すき家,大阪府,すき家 四ツ橋駅前店,大阪府大阪市西区北堀江1-7-12四ツ橋北堀江ビル1F,1090,20230923,1150,-60
すき家,大阪府,すき家 寺田町駅前店,大阪府大阪市阿倍野区天王寺町北2-1-5,1050,20230923,1120,-70
すき家,山形県,すき家 酒田若竹店,山形県酒田市若竹町2-3-5,1080,20230923,1100,-20
すき家,秋田県,すき家 秋田泉店,秋田県秋田市泉中央1-3-11,930,20230923,960,-30
すき家,大阪府,すき家 住吉遠里小野店,大阪府大阪市住吉区遠里小野2-10-30,1050,20230923,1100,-50
すき家,大阪府,すき家 住吉長居公園通店,大阪府大阪市住吉区長居東1-31,1050,20230923,1120,-70
すき家,大阪府,すき家 住之江大和川通店,大阪府大阪市住之江区新北島1-9-5,1050,20230923,1120,-70
すき家,大阪府,すき家 十三駅西口店,大阪府大阪市淀川区十三本町1-7-1カネイシビル,1100,20230923,1120,-20
すき家,青森県,すき家 十和田元町店,青森県十和田市元町東1-2-19,920,20230923,940,-20
すき家,埼玉県,すき家 春日部ユリノキ通り店,埼玉県春日部市大沼4-19,1050,20230923,1100,-50
すき家,埼玉県,すき家 春日部増田新田店,埼玉県春日部市増田新田93-1,1050,20230923,1100,-50
すき家,神奈川,すき家 小田原駅東口店,神奈川県小田原市栄町1-14-1実正堂ビル1F,1090,20230923,1150,-60
すき家,神奈川,すき家 小田原扇町店,神奈川県小田原市扇町2-5-9,1090,20230923,1150,-60
すき家,神奈川,すき家 小田原早川店,神奈川県小田原市早川3-19-6,1110,20230923,1180,-70
すき家,大阪府,すき家 松原阿保店,大阪府松原市阿保6-871-1,1050,20230923,1100,-50
すき家,大阪府,すき家 松原南新町店,大阪府松原市南新町4-107-17,1050,20230923,1100,-50
すき家,長野県,すき家 松本出川店,長野県松本市出川3-6-10,1030,20230923,1050,-20
すき家,静岡県,すき家 沼津小諏訪店,静岡県沼津市小諏訪574-8,1030,20230923,1080,-50
すき家,群馬県,すき家 沼田IC店,群馬県沼田市下久屋町1043-1,1000,20230923,1080,-80
すき家,神奈川,すき家 湘南LT店,神奈川県藤沢市大庭5434-9,1100,20230923,1150,-50
すき家,新潟県,すき家 上越高土店,新潟県上越市高土町1-1-4,1000,20230923,1030,-30
すき家,新潟県,すき家 上越春日山店,新潟県上越市大豆1-9-27,1000,20230923,1030,-30
すき家,埼玉県,すき家 上尾駅西口店,埼玉県上尾市谷津2-1-41,1050,20230923,1100,-50
すき家,埼玉県,すき家 上尾平塚店,埼玉県上尾市平塚1696-1,1050,20230923,1100,-50
すき家,埼玉県,すき家 上尾平方店,埼玉県上尾市平方領領家三ッ塚4-1,1050,20230923,1100,-50
すき家,大阪府,すき家 上六店,大阪府大阪市天王寺区上本町6-9-20,1050,20230923,1120,-70
すき家,神奈川,すき家 城山向原店,神奈川県相模原市緑区向原3-1-4,1090,20230923,1150,-60
すき家,新潟県,すき家 新井店,新潟県妙高市大字猪野山55-16,1000,20230923,1030,-30
すき家,埼玉県,すき家 新越谷駅東口店,埼玉県越谷市南越谷1-17-11新越谷プラザビル1F,1050,20230923,1100,-50
すき家,新潟県,すき家 新潟巻店,新潟県新潟市西蒲区巻甲4438-4,950,20230923,1000,-50
すき家,新潟県,すき家 新潟近江店,新潟県新潟市中央区上近江2-1-18,1000,20230923,1030,-30
すき家,新潟県,すき家 新潟大学前店,新潟県新潟市西区五十嵐一の町6711-1,950,20230923,980,-30
すき家,大阪府,すき家 新大阪西宮原店,大阪府大阪市淀川区西宮原1-8-41新大阪南愛ビル1階,1060,20230923,1120,-60
すき家,北海道,すき家 深川店,北海道深川市三条18-25,960,20230923,1000,-40
すき家,兵庫県,すき家 神戸キャンパススクエア店,兵庫県神戸市西区学園西町1-4,1030,20230923,1050,-20
すき家,神奈川,すき家 秦野室川橋店,神奈川県秦野市曽屋5788-5,1090,20230923,1120,-30
すき家,兵庫県,すき家 須磨車店,兵庫県神戸市須磨区車字奥中ノ尾767-1,1030,20230923,1060,-30
すき家,大阪府,すき家 吹田五月が丘店,大阪府吹田市五月が丘東13-19,1050,20230923,1100,-50
すき家,兵庫県,すき家 垂水塩屋北店,兵庫県神戸市垂水区朝谷町20-7,1030,20230923,1060,-30
すき家,兵庫県,すき家 垂水多聞店,兵庫県神戸市垂水区本多聞1-22-30,1030,20230923,1050,-20
すき家,兵庫県,すき家 垂水名谷店,兵庫県神戸市垂水区名谷町字横尾1818-1,1030,20230923,1040,-10
すき家,茨城県,すき家 水戸河和田店,茨城県水戸市河和田1丁目1704番14-13,1000,20230923,1020,-20
すき家,茨城県,すき家 水戸末広町店,茨城県水戸市末広町2-3-7,980,20230923,1020,-40
すき家,茨城県,すき家 水戸柳町店,茨城県水戸市柳町1-1-8,1000,20230923,1050,-50
すき家,静岡県,すき家 清水IC店,静岡県静岡市清水区八坂東2-16-21,1000,20230923,1080,-80
すき家,大阪府,すき家 生野巽東店,大阪府大阪市生野区巽東3-13-10,1050,20230923,1120,-70
すき家,大阪府,すき家 西九条駅前店,大阪府大阪市此花区西九条4-3-39村本ビル1F,1070,20230923,1120,-50
すき家,栃木県,すき家 西那須野店,栃木県那須塩原市睦104-31,980,20230923,1000,-20
すき家,大阪府,すき家 西本町店,大阪府大阪市西区西本町1-7-14日宝信濃橋センター,1120,20230923,1200,-80
すき家,青森県,すき家 青森西店,青森県青森市篠田2-19-26,930,20230923,950,-20
すき家,青森県,すき家 青森問屋町店,青森県青森市第二問屋町1-2-1,930,20230923,950,-20
すき家,青森県,すき家 青森浪打店,青森県青森市浪打2-11-20,930,20230923,950,-20
すき家,静岡県,すき家 静岡安西店,静岡県静岡市葵区安西1-2-18,1050,20230923,1080,-30
すき家,北海道,すき家 石狩花川店,北海道石狩市花川南6条1-11-50,1000,20230923,1020,-20
すき家,大阪府,すき家 摂津鳥飼中店,大阪府摂津市鳥飼中2-2-50,1050,20230923,1100,-50
すき家,大阪府,すき家 摂津南別府店,大阪府摂津市南別府町3-19,1050,20230923,1100,-50
すき家,大阪府,すき家 摂津富田店,大阪府高槻市大畑町26-17,1050,20230923,1100,-50
すき家,兵庫県,すき家 川西火打店,兵庫県川西市火打2-9-23,1030,20230923,1050,-20
すき家,大阪府,すき家 泉大津松之浜店,大阪府泉大津市松之浜町2-1-12,1050,20230923,1100,-50
すき家,大阪府,すき家 泉南中小路店,大阪府泉南市中小路2-383,1050,20230923,1100,-50
すき家,大阪府,すき家 船場中央店,大阪府大阪市中央区南本町3-2-6,1120,20230923,1200,-80
すき家,神奈川,すき家 相模原共和店,神奈川県相模原市中央区共和3-6-17,1090,20230923,1130,-40
すき家,神奈川,すき家 相模原小町通店,神奈川県相模原市中央区小町通2-4-12,1090,20230923,1150,-60
すき家,神奈川,すき家 相模原田名店,神奈川県相模原市中央区田名4679-10,1090,20230923,1120,-30
すき家,神奈川,すき家 相模原緑が丘店,神奈川県相模原市中央区緑が丘1-46-28,1090,20230923,1180,-90
すき家,静岡県,すき家 袋井川井店,静岡県袋井市川井字杉ノ木996-2,1050,20230923,1080,-30
すき家,大阪府,すき家 大国町駅前店,大阪府大阪市浪速区敷津東3-11-10AKI難波ビル1F,1050,20230923,1120,-70
すき家,大阪府,すき家 大阪港駅前店,大阪府大阪市港区築港3-6-13,1070,20230923,1150,-80
すき家,大阪府,すき家 大阪鶴見今津北店,大阪府大阪市鶴見区今津北4-4-3,1050,20230923,1100,-50
すき家,大阪府,すき家 大正三軒家東店,大阪府大阪市大正区三軒家東4-6-12,1050,20230923,1120,-70
すき家,大阪府,すき家 大正泉尾店,大阪府大阪市大正区泉尾5-1-4,1050,20230923,1120,-70
すき家,群馬県,すき家 大泉中央店,群馬県邑楽郡大泉町中央1-7-20,1000,20230923,1050,-50
すき家,大阪府,すき家 大池橋店,大阪府大阪市生野区中川西3-10-10,1050,20230923,1120,-70
すき家,大阪府,すき家 谷町三丁目店,大阪府大阪市中央区谷町3-5-5アイドュビル1F,1120,20230923,1180,-60
すき家,東京都,すき家 中葛西店,東京都江戸川区中葛西6-1-10メゾンド佐久間Ⅱ,1160,20230923,1200,-40
すき家,大阪府,すき家 中環大日店,大阪府門真市向島3-35ベア-ズA棟,1050,20230923,1100,-50
すき家,北海道,すき家 中標津店,北海道標津郡中標津町東6条南11-1-2,1000,20230923,1020,-20
すき家,神奈川,すき家 朝比奈店,神奈川県横浜市金沢区六浦4-11-34サングレイスビル101,1090,20230923,1120,-30
すき家,大阪府,すき家 長吉出戸店,大阪府大阪市平野区長吉出戸5-3-62,1050,20230923,1100,-50
すき家,大阪府,すき家 長居店,大阪府大阪市住吉区長居東4-21-2泉第2ハイツ,1050,20230923,1120,-70
すき家,静岡県,すき家 長泉下土狩店,静岡県駿東郡長泉町下土狩429-1-1,1030,20230923,1080,-50
すき家,兵庫県,すき家 長田浜添通店,兵庫県神戸市長田区浜添通6-1-25,1030,20230923,1050,-20
すき家,大阪府,すき家 長堀橋駅南店,大阪府大阪市中央区島之内1-21-19協和島之内ビル1F,1120,20230923,1200,-80
すき家,神奈川,すき家 追浜駅前店,神奈川県横須賀市追浜町3-8,1090,20230923,1120,-30
すき家,神奈川,すき家 辻堂店,神奈川県藤沢市辻堂東海岸1-2-1,1100,20230923,1130,-30
すき家,山形県,すき家 鶴岡道形店,山形県鶴岡市道形字二ツ屋61-2,1080,20230923,1100,-20
すき家,大阪府,すき家 天下茶屋駅前店,大阪府大阪市西成区岸里1-1-79とれび天下茶屋,1050,20230923,1120,-70
すき家,大阪府,すき家 天神橋二丁目店,大阪府大阪市北区天神橋2-4-14盛岡ビル1F,1100,20230923,1150,-50
すき家,大阪府,すき家 都島IC店,大阪府大阪市都島区高倉町3-14-27,1080,20230923,1120,-40
すき家,大阪府,すき家 都島本通店,大阪府大阪市都島区都島本通3-20-1,1080,20230923,1120,-40
すき家,兵庫県,すき家 東園田店,兵庫県尼崎市東園田町4-63-1,1060,20230923,1080,-20
すき家,神奈川,すき家 東海大前店,神奈川県秦野市南矢名3-12-3,1090,20230923,1120,-30
すき家,大阪府,すき家 東住吉杭全店,大阪府大阪市東住吉区杭全5-13-7,1050,20230923,1120,-70
すき家,埼玉県,すき家 東大宮駅前店,埼玉県さいたま市見沼区東大宮5-1-2東大宮東口扶桑ビル1F,1050,20230923,1100,-50
すき家,大阪府,すき家 東大阪加納店,大阪府東大阪市加納8-24-7,1050,20230923,1100,-50
すき家,大阪府,すき家 東大阪高井田店,大阪府東大阪市高井田本通7-1-30,1050,20230923,1100,-50
すき家,大阪府,すき家 東大阪菱屋西店,大阪府東大阪市菱屋西6-9-15,1050,20230923,1100,-50
すき家,大阪府,すき家 東大阪菱屋東店,大阪府東大阪市菱屋東2-3-29,1050,20230923,1100,-50
すき家,埼玉県,すき家 東武蒲生駅前店,埼玉県越谷市蒲生寿町16-18,1050,20230923,1100,-50
すき家,大阪府,すき家 東淀川菅原店,大阪府大阪市東淀川区菅原7-5-31,1100,20230923,1120,-20
すき家,大阪府,すき家 東淀川大桐店,大阪府大阪市東淀川区大桐1-7-8,1080,20230923,1120,-40
すき家,大阪府,すき家 藤井寺駅前店,大阪府藤井寺市岡2-8-46アコ-ルアン1F,1050,20230923,1100,-50
すき家,神奈川,すき家 藤沢湘南台店,神奈川県藤沢市湘南台4-14-4,1100,20230923,1120,-20
すき家,大阪府,すき家 道頓堀一丁目店,大阪府大阪市中央区道頓堀1-1-11K-24ビル1F,1120,20230923,1200,-80
すき家,福井県,すき家 敦賀木崎店,福井県敦賀市木崎19-14-1,1100,20230923,1150,-50
すき家,大阪府,すき家 内環状守口太子橋店,大阪府守口市緑町3-12,1080,20230923,1120,-40
すき家,大阪府,すき家 内環状新深江店,大阪府大阪市東成区深江南2-12-22,1050,20230923,1100,-50
すき家,兵庫県,すき家 灘中郷店,兵庫県神戸市灘区中郷町3-2-13,1030,20230923,1080,-50
すき家,大阪府,すき家 南港通り北加賀屋店,大阪府大阪市住之江区北加賀屋2-11-8北加賀屋千島ビル,1050,20230923,1120,-70
すき家,大阪府,すき家 南船場店,大阪府大阪市中央区南船場2-2-10,1120,20230923,1200,-80
すき家,大阪府,すき家 南堀江店,大阪府大阪市西区南堀江2-1-1EG堀江ビル1F,1120,20230923,1200,-80
すき家,大阪府,すき家 難波元町店,大阪府大阪市浪速区難波中3-6-12ナンバグランドビル,1070,20230923,1150,-80
すき家,神奈川,すき家 二宮店,神奈川県中郡二宮町二宮1352-4,1090,20230923,1180,-90
すき家,大阪府,すき家 梅田太融寺店,大阪府大阪市北区太融寺町5-8ダイヤモンドレジャ-ビル本館1F,1180,20230923,1200,-20
すき家,大阪府,すき家 梅田茶屋町店,大阪府大阪市北区茶屋町1-52コモド梅田ビル1F,1180,20230923,1200,-20
すき家,大阪府,すき家 梅田堂山店,大阪府大阪市北区堂山町15-15,1180,20230923,1200,-20
すき家,大阪府,すき家 柏原片山店,大阪府柏原市片山町14-1,1050,20230923,1100,-50
すき家,埼玉県,すき家 白岡岡泉店,埼玉県白岡市太田新井1187-4,1050,20230923,1100,-50
すき家,新潟県,すき家 白根店,新潟県新潟市南区鰺潟四反田605-1,950,20230923,1000,-50
すき家,北海道,すき家 函館漁火通店,北海道函館市広野町3-3,980,20230923,1000,-20
すき家,北海道,すき家 函館鍛治店,北海道函館市鍛治2-9-11,980,20230923,1000,-20
すき家,青森県,すき家 八戸根城店,青森県八戸市根城3-4-5,920,20230923,940,-20
すき家,京都府,すき家 八幡店,京都府八幡市八幡五反田39-4,1020,20230923,1050,-30
すき家,大阪府,すき家 八尾山賀店,大阪府八尾市山賀町1-37,1050,20230923,1100,-50
すき家,大阪府,すき家 八尾青山店,大阪府八尾市青山町4-2-38,1050,20230923,1100,-50
すき家,大阪府,すき家 八尾南木の本店,大阪府八尾市南木の本4-101-1,1050,20230923,1100,-50
すき家,兵庫県,すき家 板宿店,兵庫県神戸市須磨区大黒町3-3-26山本ビル,1030,20230923,1050,-20
すき家,静岡県,すき家 富士厚原店,静岡県富士市厚原99-5,1030,20230923,1050,-20
すき家,静岡県,すき家 富士今泉店,静岡県富士市今泉1-70-4,1030,20230923,1050,-20
すき家,大阪府,すき家 富田林小金台店,大阪府富田林市小金台1-3-10,1050,20230923,1100,-50
すき家,大阪府,すき家 富田林川面店,大阪府富田林市川面町2-4-16,1050,20230923,1100,-50
すき家,神奈川,すき家 淵野辺北口店,神奈川県相模原市中央区淵野辺3-19-11大黒屋ビル1F,1090,20230923,1120,-30
すき家,神奈川,すき家 平塚松風店,神奈川県平塚市松風町11-20,1090,20230923,1130,-40
すき家,神奈川,すき家 平塚上平塚店,神奈川県平塚市上平塚1-54,1090,20230923,1130,-40
すき家,神奈川,すき家 平塚店,神奈川県平塚市平塚1-9-26,1090,20230923,1120,-30
すき家,神奈川,すき家 平塚豊田店,神奈川県平塚市豊田本郷1740-1,1090,20230923,1150,-60
すき家,大阪府,すき家 平野町一丁目店,大阪府大阪市中央区平野町1-8-11ルート北浜ビル1F,1120,20230923,1200,-80
すき家,大阪府,すき家 弁天町みなと通店,大阪府大阪市港区磯路1-1-7灘浜ビル,1050,20230923,1120,-70
すき家,兵庫県,すき家 宝塚安倉店,兵庫県宝塚市安倉西4-608,1030,20230923,1050,-20
すき家,兵庫県,すき家 宝塚小林店,兵庫県宝塚市小林5-9-100,1030,20230923,1050,-20
すき家,兵庫県,すき家 宝塚中筋店,兵庫県宝塚市中筋6-13-22,1030,20230923,1050,-20
すき家,新潟県,すき家 豊栄北陽店,新潟県新潟市北区北陽1-2480-5,950,20230923,980,-30
すき家,大阪府,すき家 豊中熊野町店,大阪府豊中市熊野町1-7-15,1060,20230923,1100,-40
すき家,大阪府,すき家 豊中曽根店,大阪府豊中市曽根南町3-19-24,1060,20230923,1100,-40
すき家,大阪府,すき家 豊中浜店,大阪府豊中市浜4-3-7-2,1060,20230923,1100,-40
すき家,神奈川,すき家 本厚木一番街店,神奈川県厚木市中町2-12-1,1090,20230923,1130,-40
すき家,神奈川,すき家 本厚木店,神奈川県厚木市中町3-13-1,1090,20230923,1130,-40
すき家,大阪府,すき家 枚方山之上店,大阪府枚方市山之上北町1-8,1050,20230923,1100,-50
すき家,大阪府,すき家 枚方渚内野店,大阪府枚方市渚内野4-25-1,1050,20230923,1100,-50
すき家,大阪府,すき家 枚方招提北店,大阪府枚方市招提北町1-2241-1,1050,20230923,1100,-50
すき家,大阪府,すき家 枚方中宮東之町店,大阪府枚方市中宮東之町22-13,1050,20230923,1100,-50
すき家,長野県,すき家 箕輪BP店,長野県上伊那郡箕輪町中箕輪11338-1,1000,20230923,1030,-30
すき家,兵庫県,すき家 妙法寺駅前店,兵庫県神戸市須磨区横尾1-5リファーレ横尾1F,1030,20230923,1050,-20
すき家,大阪府,すき家 門真下馬伏店,大阪府門真市下馬伏町26-6,1050,20230923,1100,-50
すき家,大阪府,すき家 門真中央店,大阪府門真市大池町16-25,1050,20230923,1100,-50
すき家,大阪府,すき家 淀川加島店,大阪府大阪市淀川区加島2-3-4,1050,20230923,1100,-50
すき家,大阪府,すき家 淀川通塚本店,大阪府大阪市淀川区塚本2-14-19,1100,20230923,1120,-20
すき家,神奈川,すき家 立場店,神奈川県横浜市泉区中田西1-1-41,1100,20230923,1130,-30
すき家,大阪府,すき家 立売堀二丁目店,大阪府大阪市西区立売堀2-4-6DGビルなにわ筋1F,1120,20230923,1200,-80
すき家,兵庫県,すき家 鈴蘭台鳴子店,兵庫県神戸市北区鳴子2-1-4,1030,20230923,1050,-20
すき家,埼玉県,すき家 蓮田西新宿店,埼玉県蓮田市西新宿2-105,1050,20230923,1100,-50
すき家,大阪府,すき家 和泉はつが野店,大阪府和泉市はつが野1-1-13,1050,20230923,1100,-50
すき家,兵庫県,すき家 脇浜店,兵庫県神戸市中央区脇浜町2-5-19,1050,20230923,1080,-30
