松屋,千葉県,松屋 成田空港第3ターミナル店,千葉県成田市取香148-1,1300,20230909,1200,100
すき家,秋田県,すき家 101号男鹿店,秋田県男鹿市船越字内子294-1881,950,20230909,900,50
すき家,秋田県,すき家 105号由利本荘店,秋田県由利本荘市御門228-1,950,20230909,910,40
すき家,鹿児島,すき家 10号姶良宮島店,鹿児島県姶良市西餠田522-2,1000,20230909,950,50
すき家,大分県,すき家 10号宇佐店,大分県宇佐市大字辛島286-1,980,20230909,950,30
すき家,宮崎県,すき家 10号延岡別府町店,宮崎県延岡市別府町3895-1,980,20230909,920,60
すき家,大分県,すき家 10号大分大学前店,大分県大分市鴛野1373-1,950,20230909,920,30
すき家,宮崎県,すき家 10号日向原町店,宮崎県日向市原町2-11,950,20230909,920,30
すき家,宮城県,すき家 113号角田店,宮城県角田市角田字扇町5-5,980,20230909,930,50
すき家,福島県,すき家 115号福島方木田店,福島県福島市大森字北島45-1,980,20230909,930,50
すき家,新潟県,すき家 116号吉田店,新潟県燕市吉田字流間3716-3,1030,20230909,950,80
すき家,香川県,すき家 11号高松屋島店,香川県高松市高松町3009-9,970,20230909,950,20
すき家,香川県,すき家 11号高松春日店,香川県高松市春日町1626-1,970,20230909,950,20
すき家,埼玉県,すき家 122号騎西店,埼玉県加須市騎西字高道460-1,1080,20230909,1000,80
すき家,茨城県,すき家 125号阿見店,茨城県稲敷郡阿見町中郷2-29-16,1020,20230909,980,40
すき家,埼玉県,すき家 125号加須諏訪店,埼玉県加須市諏訪1-15-1,1080,20230909,1030,50
すき家,埼玉県,すき家 125号久喜栗橋店,埼玉県久喜市栗橋1301-3,1080,20230909,1050,30
すき家,茨城県,すき家 125号八千代町店,茨城県結城郡八千代町菅谷604-1,1050,20230909,1000,50
すき家,千葉県,すき家 126号山武松尾店,千葉県山武市松尾町八田7-1,1100,20230909,1050,50
すき家,千葉県,すき家 126号千葉弁天店,千葉県千葉市中央区弁天4-11-26,1080,20230909,1050,30
すき家,千葉県,すき家 126号東金南上宿店,千葉県東金市南上宿5-38-33,1080,20230909,1050,30
すき家,千葉県,すき家 128号東茂原店,千葉県茂原市東茂原1-41,1100,20230909,1050,50
すき家,静岡県,すき家 135号伊東吉田店,静岡県伊東市吉田346-1,1050,20230909,1000,50
すき家,静岡県,すき家 135号熱海店,静岡県熱海市下多賀572-2,1030,20230909,1000,30
すき家,福島県,すき家 13号福島矢野目店,福島県福島市北矢野目字原田66-13,980,20230909,930,50
すき家,山形県,すき家 13号米沢花沢店,山形県米沢市花沢710-7,980,20230909,930,50
すき家,埼玉県,すき家 140号秩父野坂店,埼玉県秩父市野坂町2-1-21,1080,20230909,1050,30
すき家,東京都,すき家 14号江戸川一之江店,東京都江戸川区一之江1-8-4,1160,20230909,1120,40
すき家,東京都,すき家 14号江戸川篠崎店,東京都江戸川区篠崎町7-1-17,1160,20230909,1120,40
すき家,東京都,すき家 14号江戸川松江店,東京都江戸川区松江1-8-8,1160,20230909,1120,40
すき家,千葉県,すき家 14号習志野谷津店,千葉県習志野市谷津2-18-45,1100,20230909,1050,50
すき家,静岡県,すき家 150号御前崎浜岡店,静岡県御前崎市池新田字下水神7625-2,1080,20230909,1000,80
すき家,静岡県,すき家 150号焼津八楠店,静岡県焼津市八楠3-19-1,1080,20230909,1030,50
すき家,静岡県,すき家 150号大須賀店,静岡県掛川市西大渕1684-1,1080,20230909,1000,80
すき家,静岡県,すき家 150号牧之原店,静岡県牧之原市静波2161-1,1080,20230909,1030,50
すき家,愛知県,すき家 151号豊川IC店,愛知県豊川市大橋町2-1,1100,20230909,1030,70
すき家,愛知県,すき家 155号稲沢一色店,愛知県稲沢市一色下方町285-3,1100,20230909,1050,50
すき家,愛知県,すき家 155号常滑大鳥店,愛知県常滑市虹の丘三丁目53-2,1100,20230909,1030,70
すき家,愛知県,すき家 155号知多新舞子店,愛知県知多市旭南2-48-1,1100,20230909,1030,70
すき家,愛知県,すき家 155号津島店,愛知県津島市申塚町2-143-1,1100,20230909,1050,50
すき家,奈良県,すき家 168号生駒壱分店,奈良県生駒市有里町108-1,1000,20230909,970,30
すき家,奈良県,すき家 169号桜井三輪店,奈良県桜井市三輪114-4,1000,20230909,950,50
すき家,奈良県,すき家 169号天理勾田店,奈良県天理市勾田町82-1,1000,20230909,930,70
すき家,奈良県,すき家 169号奈良紀寺町店,奈良県奈良市紀寺町682-1,1000,20230909,930,70
すき家,埼玉県,すき家 16号狭山上奥富店,埼玉県狭山市上奥富51-1,1100,20230909,1040,60
すき家,埼玉県,すき家 16号春日部八丁目店,埼玉県春日部市八丁目1156-1,1080,20230909,1050,30
すき家,東京都,すき家 16号瑞穂南平店,東京都西多摩郡瑞穂町南平1-6-6,1130,20230909,1080,50
すき家,千葉県,すき家 16号千葉北IC店,千葉県千葉市稲毛区長沼町135-4,1100,20230909,1050,50
すき家,千葉県,すき家 16号袖ヶ浦神納店,千葉県袖ヶ浦市神納1154-1,1100,20230909,1080,20
すき家,千葉県,すき家 16号木更津貝渕店,千葉県木更津市貝渕4-10-10,1100,20230909,1050,50
すき家,兵庫県,すき家 175号平野芝崎店,兵庫県神戸市西区平野町芝崎255-1,1080,20230909,1000,80
すき家,埼玉県,すき家 17号上里店,埼玉県児玉郡上里町神保原町2211-2,1080,20230909,1050,30
すき家,埼玉県,すき家 17号深谷西店,埼玉県深谷市萱場116-1,1080,20230909,1050,30
すき家,新潟県,すき家 17号六日町IC東店,新潟県南魚沼市美佐島516-4,1080,20230909,1000,80
すき家,岡山県,すき家 180号総社店,岡山県総社市井手956-1,1000,20230909,980,20
すき家,広島県,すき家 184号尾道店,広島県尾道市栗原西2-7-14,1000,20230909,980,20
すき家,山口県,すき家 188号光浅江店,山口県光市浅江1-11-7,1000,20230909,980,20
すき家,山口県,すき家 188号柳井店,山口県柳井市南町3-7-1,1000,20230909,980,20
すき家,群馬県,すき家 18号安中原市店,群馬県安中市原市612-3,1100,20230909,1050,50
すき家,岐阜県,すき家 19号瑞浪店,岐阜県瑞浪市穂並1-64,1080,20230909,1000,80
すき家,岐阜県,すき家 19号多治見音羽店,岐阜県多治見市音羽町4-1,1080,20230909,1000,80
すき家,岐阜県,すき家 19号土岐店,岐阜県土岐市泉仲森町1-17,1080,20230909,1000,80
すき家,神奈川,すき家 1国横浜権太坂店,神奈川県横浜市保土ヶ谷区狩場町218-21,1200,20230909,1100,100
すき家,神奈川,すき家 1国横浜不動坂店,神奈川県横浜市戸塚区柏尾町928-1,1200,20230909,1090,110
すき家,愛知県,すき家 1国岡崎栄町店,愛知県岡崎市栄町5-2-1,1080,20230909,1030,50
すき家,神奈川,すき家 1国戸塚店,神奈川県横浜市戸塚区戸塚町3153-45,1160,20230909,1090,70
すき家,静岡県,すき家 1国沼津共栄店,静岡県沼津市共栄町19-4,1080,20230909,1030,50
すき家,滋賀県,すき家 1国水口店,滋賀県甲賀市水口町北泉2-2,1100,20230909,1080,20
すき家,静岡県,すき家 1国清水渋川店,静岡県静岡市清水区渋川477-4,1080,20230909,1000,80
すき家,静岡県,すき家 1国静岡馬渕店,静岡県静岡市駿河区馬渕1-17-38,1100,20230909,1030,70
すき家,滋賀県,すき家 1国草津大路店,滋賀県草津市大路3-138,1050,20230909,1030,20
すき家,滋賀県,すき家 1国大津瀬田店,滋賀県大津市大江4-5-6,1050,20230909,1030,20
すき家,静岡県,すき家 1国富士鮫島店,静岡県富士市鮫島360-1,1050,20230909,1030,20
すき家,愛知県,すき家 1国豊橋下地店,愛知県豊橋市下地町字宮腰11-9,1080,20230909,1030,50
すき家,愛知県,すき家 1国豊橋岩屋店,愛知県豊橋市岩屋町字岩屋下47-11,1080,20230909,1030,50
すき家,愛知県,すき家 1国豊川御油店,愛知県豊川市御油町池田53-4,1080,20230909,1030,50
すき家,福岡県,すき家 200号直方店,福岡県直方市大字頓野字縄手下3891-11,1000,20230909,950,50
すき家,福岡県,すき家 202号糸島前原店,福岡県糸島市前原東1-6-13,980,20230909,930,50
すき家,佐賀県,すき家 202号唐津鏡店,佐賀県唐津市鏡4664-1,970,20230909,920,50
すき家,長崎県,すき家 204号佐世保田原店,長崎県佐世保市田原町17-23,970,20230909,920,50
すき家,長崎県,すき家 207号時津店,長崎県西彼杵郡時津町浜田郷627-1,970,20230909,950,20
すき家,熊本県,すき家 208号荒尾原万田店,熊本県荒尾市原万田字八反田618-3,980,20230909,950,30
すき家,福岡県,すき家 209号筑後店,福岡県筑後市山ノ井346-3,980,20230909,950,30
すき家,東京都,すき家 20号日野万願寺店,東京都日野市万願寺5-14-8,1130,20230909,1080,50
すき家,福岡県,すき家 210号うきは店,福岡県うきは市吉井町清瀬515-2,980,20230909,950,30
すき家,福岡県,すき家 211号八幡西店,福岡県北九州市八幡西区上の原3-1-6,980,20230909,950,30
すき家,大分県,すき家 213号中津店,大分県中津市中殿町3-31-14,1000,20230909,980,20
すき家,大分県,すき家 217号臼杵店,大分県臼杵市市浜1128-1,980,20230909,920,60
すき家,岐阜県,すき家 21号岐阜各務原IC店,岐阜県各務原市那加緑町1-24-1,1080,20230909,1030,50
すき家,岐阜県,すき家 21号垂井店,岐阜県不破郡垂井町宮代字提3018-1,1080,20230909,1000,80
すき家,鹿児島,すき家 220号志布志店,鹿児島県志布志市志布志町安楽123-21,1000,20230909,950,50
すき家,宮崎県,すき家 222号日南店,宮崎県日南市中央通1-11-23,1000,20230909,950,50
すき家,鹿児島,すき家 226号指宿店,鹿児島県指宿市西方2164-1,980,20230909,920,60
すき家,北海道,すき家 236号帯広大通店,北海道帯広市大通南3-1-1,1050,20230909,1030,20
すき家,北海道,すき家 238号紋別店,北海道紋別市落石町4-13-13,1130,20230909,1100,30
すき家,愛知県,すき家 23号豊橋花田店,愛知県豊橋市花田町字荒木37-1,1080,20230909,1030,50
すき家,愛知県,すき家 247号半田店,愛知県半田市昭和町3-20,1080,20230909,1030,50
すき家,愛知県,すき家 247号美浜店,愛知県知多郡美浜町新浦戸1-11-4,1080,20230909,1030,50
すき家,愛知県,すき家 248号岡崎岩津店,愛知県岡崎市岩津町字新城107-7,1100,20230909,1030,70
すき家,愛知県,すき家 248号岡崎上六名店,愛知県岡崎市上六名町2-7-7,1100,20230909,1030,70
すき家,愛知県,すき家 248号幸田大草店,愛知県額田郡幸田町大字大草字検行132-2,1100,20230909,1030,70
すき家,奈良県,すき家 24号五條今井店,奈良県五條市今井1-11-57,1000,20230909,950,50
すき家,和歌山,すき家 24号高野口名古曽店,和歌山県橋本市高野口町名古曽948-1,1050,20230909,950,100
すき家,奈良県,すき家 24号天理嘉幡店,奈良県天理市嘉幡町590-1,1000,20230909,930,70
すき家,兵庫県,すき家 250号赤穂駅前店,兵庫県赤穂市加里屋69-11,1080,20230909,1030,50
すき家,長崎県,すき家 251号島原宮の町店,長崎県島原市宮の町648-1,1050,20230909,920,130
すき家,愛知県,すき家 259号田原店,愛知県田原市谷熊町備後42-1,1080,20230909,1030,50
すき家,奈良県,すき家 25号王寺本町店,奈良県北葛城郡王寺町本町1-17-17,1000,20230909,950,50
すき家,奈良県,すき家 25号斑鳩法隆寺店,奈良県生駒郡斑鳩町法隆寺東2-1-22,1000,20230909,950,50
すき家,熊本県,すき家 266号宇城松橋店,熊本県宇城市松橋町曲野133-4,1000,20230909,970,30
すき家,鹿児島,すき家 270号南さつま店,鹿児島県南さつま市加世田本町13-5,980,20230909,920,60
すき家,岩手県,すき家 282号八幡平店,岩手県八幡平市大更第18地割88-12,950,20230909,880,70
すき家,山形県,すき家 287号長井店,山形県長井市東町6-31,980,20230909,950,30
すき家,千葉県,すき家 296号佐倉井野店,千葉県佐倉市井野1572-2,1080,20230909,1050,30
すき家,千葉県,すき家 296号酒々井店,千葉県印旛郡酒々井町上本佐倉193-1,1100,20230909,1050,50
すき家,千葉県,すき家 296号多古店,千葉県香取郡多古町多古1534-1,1100,20230909,1050,50
すき家,千葉県,すき家 297号大多喜店,千葉県夷隅郡大多喜町船子311-3,1080,20230909,1030,50
すき家,埼玉県,すき家 299号入間野田店,埼玉県入間市野田1571-2,1080,20230909,1050,30
すき家,兵庫県,すき家 29号宍粟店,兵庫県宍粟市山崎町今宿字中筋98-14,1080,20230909,1000,80
すき家,山口県,すき家 2国下関長府店,山口県下関市長府松小田本町24-6,980,20230909,950,30
すき家,岡山県,すき家 2国笠岡店,岡山県笠岡市三番町2-30,1000,20230909,980,20
すき家,山口県,すき家 2国岩国室の木店,山口県岩国市室の木町1-8-38,1000,20230909,980,20
すき家,広島県,すき家 2国広島東雲店,広島県広島市南区東雲3-13-6,1050,20230909,1030,20
すき家,兵庫県,すき家 2国西宮北今津店,兵庫県西宮市津門稲荷町5-8,1050,20230909,1030,20
すき家,広島県,すき家 2国大竹西栄店,広島県大竹市西栄1-7-13,1000,20230909,980,20
すき家,兵庫県,すき家 2国尼崎杭瀬店,兵庫県尼崎市杭瀬北新町3-2-18,1080,20230909,1060,20
すき家,広島県,すき家 2国福山引野店,広島県福山市引野町5-19-30,1000,20230909,980,20
すき家,広島県,すき家 2国福山高西店,広島県福山市高西町4-4-9,1030,20230909,1000,30
すき家,広島県,すき家 2国福山南本庄店,広島県福山市南本庄2-7-4,1000,20230909,980,20
すき家,兵庫県,すき家 2国明石魚住店,兵庫県明石市魚住町金ヶ崎324-1,1030,20230909,980,50
すき家,兵庫県,すき家 2国明石天文町店,兵庫県明石市天文町1-8-6,1050,20230909,980,70
すき家,石川県,すき家 305号上小松店,石川県小松市上小松町137-1,1050,20230909,1030,20
すき家,兵庫県,すき家 312号姫路砥堀店,兵庫県姫路市砥堀350-2,1080,20230909,1030,50
すき家,岡山県,すき家 313号真庭店,岡山県真庭市惣146-1,1020,20230909,980,40
すき家,広島県,すき家 31号呉海岸通り店,広島県呉市海岸1-7-12,1000,20230909,980,20
すき家,熊本県,すき家 324号天草店,熊本県天草市小松原町7-12,980,20230909,900,80
すき家,熊本県,すき家 325号菊池店,熊本県菊池市隈府字北原597-2,980,20230909,950,30
すき家,沖縄県,すき家 331号南城店,沖縄県南城市佐敷津波古1356-2,950,20230909,900,50
すき家,茨城県,すき家 349号那珂店,茨城県那珂市竹ノ内4-11-8,1050,20230909,980,70
すき家,佐賀県,すき家 34号小城三日月店,佐賀県小城市三日月町金田1101-1,980,20230909,950,30
すき家,長崎県,すき家 34号大村店,長崎県大村市桜馬場2-370-1,970,20230909,920,50
すき家,長崎県,すき家 34号長崎矢上町店,長崎県長崎市矢上町52-2,970,20230909,920,50
すき家,佐賀県,すき家 34号鳥栖店,佐賀県鳥栖市萱方町177-1,970,20230909,950,20
すき家,佐賀県,すき家 34号武雄店,佐賀県武雄市武雄町昭和795-1,970,20230909,950,20
すき家,富山県,すき家 359号婦中店,富山県富山市婦中町下轡田444-1,1080,20230909,1030,50
すき家,長崎県,すき家 35号佐世保大和店,長崎県佐世保市大和町749-1,970,20230909,920,50
すき家,北海道,すき家 36号千歳店,北海道千歳市新富1-19-4,1000,20230909,960,40
すき家,北海道,すき家 37号室蘭中島店,北海道室蘭市中島町2-6-12,1000,20230909,950,50
すき家,福岡県,すき家 389号大牟田店,福岡県大牟田市大正町3-4-3,980,20230909,950,30
すき家,北海道,すき家 38号釧路鳥取店,北海道釧路市鳥取大通3-4-12,1000,20230909,950,50
すき家,北海道,すき家 38号帯広柏林台店,北海道帯広市西十七条南1-25-1,1050,20230909,1030,20
すき家,熊本県,すき家 3号熊本藤崎店,熊本県熊本市中央区妙体寺町2-1,950,20230909,900,50
すき家,鹿児島,すき家 3号鹿児島草牟田店,鹿児島県鹿児島市草牟田町3-1,980,20230909,950,30
すき家,福岡県,すき家 3号小倉北到津店,福岡県北九州市小倉北区上到津2-3-151F,1000,20230909,950,50
すき家,熊本県,すき家 3号水俣店,熊本県水俣市百間町1-12-1,970,20230909,920,50
すき家,埼玉県,すき家 407号熊谷弥藤吾店,埼玉県熊谷市弥藤吾1519-2,1080,20230909,1050,30
すき家,埼玉県,すき家 407号鶴ヶ島IC店,埼玉県鶴ヶ島市脚折町5-5-40,1080,20230909,1050,30
すき家,千葉県,すき家 409号八街店,千葉県八街市八街ほ26-1,1080,20230909,1050,30
すき家,北海道,すき家 40号稚内大黒店,北海道稚内市大黒2-6-24,1150,20230909,1100,50
すき家,福井県,すき家 416号福井開発店,福井県福井市開発4-309,1050,20230909,1000,50
すき家,愛知県,すき家 419号高浜店,愛知県高浜市湯山町2-5-1,1080,20230909,1030,50
すき家,愛知県,すき家 41号大口店,愛知県丹羽郡大口町中小口3-72-1,1100,20230909,1050,50
すき家,愛知県,すき家 41号豊山店,愛知県西春日井郡豊山町青山字江川73-1,1080,20230909,1050,30
すき家,和歌山,すき家 42号田辺店,和歌山県田辺市下万呂362-2,1100,20230909,1050,50
すき家,広島県,すき家 432号竹原店,広島県竹原市下野町小井手3256-1,1000,20230909,980,20
すき家,北海道,すき家 44号釧路木場店,北海道釧路郡釧路町木場1-3-3,1000,20230909,950,50
すき家,青森県,すき家 45号おいらせ店,青森県上北郡おいらせ町菜飯52-4,950,20230909,920,30
すき家,埼玉県,すき家 463号BP所沢上新井店,埼玉県所沢市上新井3-1-3,1080,20230909,1050,30
すき家,埼玉県,すき家 463号入間東店,埼玉県入間市東町6-1-24,1100,20230909,1050,50
すき家,千葉県,すき家 464号千葉NT白井店,千葉県白井市根447-2,1080,20230909,1050,30
すき家,富山県,すき家 472号射水店,富山県射水市下条新1482-1,1050,20230909,1000,50
すき家,広島県,すき家 486号備後府中店,広島県府中市高木町本堀田643-1,1000,20230909,980,20
すき家,広島県,すき家 486号福山駅家店,広島県福山市駅家町万能倉288-1,1000,20230909,980,20
すき家,福岡県,すき家 495号古賀花見店,福岡県古賀市花見東1-15-13,980,20230909,950,30
すき家,福岡県,すき家 496号行橋店,福岡県行橋市西宮市4-2-11,1000,20230909,950,50
すき家,長崎県,すき家 499号長崎江川町店,長崎県長崎市柳田町28-1,970,20230909,920,50
すき家,栃木県,すき家 4号さくら店,栃木県さくら市卯の里5-59-12,1050,20230909,1000,50
すき家,宮城県,すき家 4号栗原店,宮城県栗原市志波姫堀口宮中113-8,960,20230909,930,30
すき家,宮城県,すき家 4号古川西館店,宮城県大崎市古川西館3-9-1,950,20230909,930,20
すき家,岩手県,すき家 4号紫波店,岩手県紫波郡紫波町桜町字浦田14-1,930,20230909,900,30
すき家,宮城県,すき家 4号柴田店,宮城県柴田郡柴田町西船迫1-1-55,950,20230909,930,20
すき家,岩手県,すき家 4号盛岡上田店,岩手県盛岡市上田4-20-47,950,20230909,900,50
すき家,岩手県,すき家 4号盛岡西見前店,岩手県盛岡市西見前18-35-9,950,20230909,900,50
すき家,岩手県,すき家 4号盛岡茶畑店,岩手県盛岡市茶畑2-22-1,950,20230909,900,50
すき家,宮城県,すき家 4号仙台郡山店,宮城県仙台市太白区郡山字出丸1-1,980,20230909,930,50
すき家,東京都,すき家 4号足立保木間店,東京都足立区西保木間1-17-20,1160,20230909,1120,40
すき家,岩手県,すき家 4号滝沢店,岩手県滝沢市巣子109-2,920,20230909,880,40
すき家,福島県,すき家 4号福島伊達店,福島県伊達市鍛治屋川27-1,980,20230909,930,50
すき家,福島県,すき家 4号福島黒岩店,福島県福島市黒岩堂之後55-1,980,20230909,930,50
すき家,福島県,すき家 4号福島松浪店,福島県福島市松浪町11-7,980,20230909,930,50
すき家,福岡県,すき家 500号小郡店,福岡県小郡市小郡字江下1483-4,980,20230909,950,30
すき家,栃木県,すき家 50号岩舟静店,栃木県栃木市岩舟町静2167-1,1050,20230909,1010,40
すき家,群馬県,すき家 50号桐生広沢店,群馬県桐生市広沢町三丁目字反町4023-2,1070,20230909,1050,20
すき家,茨城県,すき家 50号筑西蓮沼店,茨城県筑西市蓮沼1534-1,1050,20230909,1000,50
すき家,茨城県,すき家 51号潮来店,茨城県潮来市延方西1462-3,1050,20230909,1000,50
すき家,静岡県,すき家 52号清水興津店,静岡県静岡市清水区興津中町字金山下1371-1,1080,20230909,1000,80
すき家,広島県,すき家 54号広島IC店,広島県広島市安佐南区緑井5-19-36,1000,20230909,980,20
すき家,愛媛県,すき家 56号大洲松ヶ花店,愛媛県大洲市新谷乙543-1,1020,20230909,950,70
すき家,熊本県,すき家 57号大津店,熊本県菊池郡大津町大字大津1302-1,970,20230909,950,20
すき家,長崎県,すき家 57号諫早小川町店,長崎県諫早市小川町53-1,970,20230909,920,50
すき家,沖縄県,すき家 58号読谷店,沖縄県中頭郡読谷村伊良皆661-1,980,20230909,950,30
すき家,北海道,すき家 5号小樽朝里店,北海道小樽市新光2-1-4,1000,20230909,980,20
すき家,茨城県,すき家 6号ひたちなか田彦店,茨城県ひたちなか市大字田彦1569-1,1050,20230909,1000,50
すき家,千葉県,すき家 6号松戸きよしヶ丘店,千葉県松戸市小金きよしヶ丘4-11-6,1080,20230909,1050,30
すき家,茨城県,すき家 6号北茨城店,茨城県北茨城市関南町神岡上字二ツ島26-2,1020,20230909,1000,20
すき家,秋田県,すき家 7号にかほ店,秋田県にかほ市平沢字町田129-1,1000,20230909,910,90
すき家,山形県,すき家 7号酒田こあら店,山形県酒田市こあら二丁目1-1,1080,20230909,1050,30
すき家,石川県,すき家 8号金沢福久店,石川県金沢市福久東1-37,1050,20230909,1030,20
すき家,福井県,すき家 8号坂井丸岡店,福井県坂井市丸岡町朝陽2-102-1,1050,20230909,1000,50
すき家,京都府,すき家 9号亀岡篠町店,京都府亀岡市篠町野条上又13-1,1050,20230909,1000,50
すき家,京都府,すき家 9号亀岡千代川店,京都府亀岡市千代川町高野林西ノ畑15-5,1050,20230909,1000,50
すき家,島根県,すき家 9号松江西津田店,島根県松江市西津田5-1-11,1000,20230909,950,50
すき家,兵庫県,すき家 JR西宮駅北口店,兵庫県西宮市西福町2-23イサダビル1F,1050,20230909,1030,20
すき家,東京都,すき家 JR町田駅南口店,東京都町田市原町田1-2-6第2ひろせビル1F,1140,20230909,1120,20
すき家,兵庫県,すき家 JR尼崎駅北口店,兵庫県尼崎市潮江1-3-43,1100,20230909,1060,40
すき家,神奈川,すき家 bono相模大野店,神奈川県相模原市南区相模大野3-3-2-203bono相模大野,1140,20230909,1090,50
すき家,東京都,すき家 あきる野睦橋通り店,東京都あきる野市秋留2-1-5,1130,20230909,1080,50
すき家,沖縄県,すき家 うるま安慶名店,沖縄県うるま市安慶名1-4-10,960,20230909,920,40
すき家,沖縄県,すき家 うるま石川店,沖縄県うるま市石川2-11-1,960,20230909,920,40
すき家,沖縄県,すき家 うるま前原店,沖縄県うるま市前原169-4-3,960,20230909,920,40
すき家,千葉県,すき家 おゆみ野店,千葉県千葉市緑区おゆみ野南5-7-1,1080,20230909,1070,10
すき家,埼玉県,すき家 さいたま本郷町店,埼玉県さいたま市北区本郷町689-1,1120,20230909,1100,20
すき家,茨城県,すき家 つくば学園西大通り店,茨城県つくば市筑穂1-5-7,1050,20230909,1000,50
すき家,茨城県,すき家 つくば上横場店,茨城県つくば市上横場2289-3,1050,20230909,1000,50
すき家,茨城県,すき家 つくば中央店,茨城県つくば市松代1-6-4,1050,20230909,1000,50
すき家,東京都,すき家 とうきょうスカイツリー駅前店,東京都墨田区業平1-18-12,1250,20230909,1150,100
すき家,東京都,すき家 ときわ台駅北口店,東京都板橋区常盤台2-6-5,1200,20230909,1100,100
すき家,茨城県,すき家 ひたちなか店,茨城県ひたちなか市中根3319-6,1020,20230909,1000,20
すき家,長崎県,すき家 みらい長崎ココウォーク店,長崎県長崎市茂里町1-55みらい長崎ココウォーク3F,950,20230909,900,50
すき家,東京都,すき家 アキバ田代通り店,東京都千代田区外神田4-5-8松孝商事ビル1F,1250,20230909,1200,50
すき家,兵庫県,すき家 イオンタウン太子店,兵庫県揖保郡太子町東出262-1,1030,20230909,1000,30
すき家,秋田県,すき家 イオンモール秋田店,秋田県秋田市御所野地蔵田1-1-1,950,20230909,900,50
すき家,岩手県,すき家 イオンモール盛岡南店,岩手県盛岡市本宮7-1-1,950,20230909,900,50
すき家,群馬県,すき家 イオンモール太田店,群馬県太田市石原町81イオンモ-ル太田2F,1050,20230909,1010,40
すき家,千葉県,すき家 イオンモール柏店,千葉県柏市豊町2-5-25イオンモール柏2F,1050,20230909,1020,30
すき家,福岡県,すき家 イオンモール福津店,福岡県福津市日蒔野6-16-1イオンモール福津3F,1000,20230909,950,50
すき家,千葉県,すき家 イオン海浜幕張店,千葉県千葉市美浜区ひび野1-3イオン幕張,1080,20230909,1050,30
すき家,千葉県,すき家 イオン千葉NT店,千葉県印西市中央北3-2,1100,20230909,1080,20
すき家,東京都,すき家 イオン東雲店,東京都江東区東雲1-9-10イオン東雲店2Fフードコート内,1250,20230909,1230,20
すき家,沖縄県,すき家 イオン那覇店,沖縄県那覇市金城5-10-2イオン那覇1F,950,20230909,930,20
すき家,福島県,すき家 イオン福島店,福島県福島市南矢野目西荒田50-17,980,20230909,930,50
すき家,東京都,すき家 イトーヨーカドー国領店,東京都調布市国領町8-2-64イト-ヨ-カド-国領店1F,1180,20230909,1120,60
すき家,東京都,すき家 ウィラ大井店,東京都品川区勝島1-6-16,1250,20230909,1200,50
すき家,東京都,すき家 グリナード永山店,東京都多摩市永山1-4グリナード永山1F,1130,20230909,1100,30
すき家,東京都,すき家 サンライズ蒲田店,東京都大田区西蒲田7-51-2ベルコーサ1F,1250,20230909,1180,70
すき家,千葉県,すき家 ニッケコルトンプラザ店,千葉県市川市鬼高1-1-1,1100,20230909,1050,50
すき家,東京都,すき家 ハッピーロード大山店,東京都板橋区大山町24-10常磐ビル1F,1200,20230909,1120,80
すき家,東京都,すき家 フレスポ若葉台店,東京都稲城市若葉台2-1-1,1130,20230909,1100,30
すき家,静岡県,すき家 ベイドリーム清水店,静岡県静岡市清水区駒越北町8-3,1080,20230909,1000,80
すき家,岡山県,すき家 ポルカ高梁店,岡山県高梁市中原町1079-1,950,20230909,900,50
すき家,埼玉県,すき家 モラージュ菖蒲店,埼玉県久喜市菖蒲町菖蒲6005-1,1220,20230909,1200,20
すき家,千葉県,すき家 ユニモちはら台店,千葉県市原市ちはら台西3-4ショッピングモ-ルユニモちはら台2F,1100,20230909,1050,50
すき家,東京都,すき家 ワンザ有明店,東京都江東区有明3-6-11TFTビル東館2F,1350,20230909,1300,50
すき家,徳島県,すき家 阿南富岡店,徳島県阿南市富岡町10-1,1020,20230909,950,70
すき家,愛知県,すき家 愛知学院大学前店,愛知県長久手市長配2-601,1080,20230909,1050,30
すき家,千葉県,すき家 旭店,千葉県旭市二字宮前1684-1,1080,20230909,1050,30
すき家,東京都,すき家 綾瀬駅南店,東京都葛飾区小菅4-10-2,1160,20230909,1120,40
すき家,群馬県,すき家 安中店,群馬県安中市中宿1丁目字石合891-1,1100,20230909,1050,50
すき家,福島県,すき家 伊達保原店,福島県伊達市保原町字市柳町7-1,980,20230909,930,50
すき家,東京都,すき家 井ノ頭通り吉祥寺店,東京都武蔵野市吉祥寺南町3-33-3,1200,20230909,1150,50
すき家,愛知県,すき家 一宮駅前店,愛知県一宮市栄3-7-1石照ビル1F,1100,20230909,1080,20
すき家,愛知県,すき家 一宮中島通店,愛知県一宮市中島通1-32-2,1100,20230909,1050,50
すき家,愛知県,すき家 一宮妙興寺店,愛知県一宮市宮地2-13-4,1100,20230909,1050,50
すき家,東京都,すき家 一之江駅前店,東京都江戸川区一之江3-2-14,1160,20230909,1120,40
すき家,東京都,すき家 稲荷町駅前店,東京都台東区東上野5-1-4,1250,20230909,1150,100
すき家,東京都,すき家 稲城矢野口店,東京都稲城市矢野口323-7,1180,20230909,1120,60
すき家,愛知県,すき家 稲沢小池店,愛知県稲沢市小池3-10-25,1100,20230909,1050,50
すき家,栃木県,すき家 宇都宮インターパーク店,栃木県宇都宮市インターパーク6-5-2,1080,20230909,1050,30
すき家,埼玉県,すき家 羽生店,埼玉県羽生市南6丁目21-2,1080,20230909,1000,80
すき家,東京都,すき家 鵜の木駅前店,東京都大田区鵜の木2-15-2山口ビル1F,1250,20230909,1200,50
すき家,千葉県,すき家 浦安堀江店,千葉県浦安市堀江6-4-29メゾン浦安1F,1100,20230909,1050,50
すき家,東京都,すき家 荏原町駅前店,東京都品川区中延5-3-10,1250,20230909,1150,100
すき家,東京都,すき家 永福町駅前店,東京都杉並区永福2-51-13,1150,20230909,1120,30
すき家,福井県,すき家 越前押田店,福井県越前市押田2-1-1,1050,20230909,1000,50
すき家,埼玉県,すき家 越谷花田店,埼玉県越谷市花田2-33-1,1080,20230909,1050,30
すき家,埼玉県,すき家 越谷相模町店,埼玉県越谷市相模町1-233-1,1100,20230909,1050,50
すき家,宮城県,すき家 塩竈北浜店,宮城県塩竈市北浜1-13-30,980,20230909,930,50
すき家,神奈川,すき家 横浜アリーナ前店,神奈川県横浜市港北区新横浜3-17-20ヒューマンハイム新横浜,1250,20230909,1220,30
すき家,神奈川,すき家 横浜羽沢店,神奈川県横浜市神奈川区羽沢町1566-1,1200,20230909,1140,60
すき家,神奈川,すき家 横浜笠間店,神奈川県横浜市栄区笠間5-33-26,1160,20230909,1090,70
すき家,神奈川,すき家 横浜上郷店,神奈川県横浜市栄区上郷町199-1,1160,20230909,1090,70
すき家,神奈川,すき家 横浜日野中央店,神奈川県横浜市港南区日野中央2-42-1,1160,20230909,1090,70
すき家,東京都,すき家 王子駅前店,東京都北区王子1-4-1サンスクエア前庭,1200,20230909,1150,50
すき家,愛知県,すき家 岡崎緑丘店,愛知県岡崎市緑丘2-15-21,1100,20230909,1030,70
すき家,岡山県,すき家 岡山新保店,岡山県岡山市南区新保395-1,1020,20230909,1000,20
すき家,岡山県,すき家 岡山西大寺店,岡山県岡山市東区松新町3-1,1000,20230909,980,20
すき家,岡山県,すき家 岡山大学前店,岡山県岡山市北区学南町2-811-1メゾン仏蘭西1F,980,20230909,950,30
すき家,岡山県,すき家 岡山福田店,岡山県岡山市南区福田229-1,1020,20230909,1000,20
すき家,岡山県,すき家 岡山野田店,岡山県岡山市北区野田3-17-1,1020,20230909,1000,20
すき家,東京都,すき家 荻窪駅西口店,東京都杉並区荻窪5-26-11マチダビル1F,1200,20230909,1180,20
すき家,東京都,すき家 荻窪三丁目店,東京都杉並区荻窪3-47-23,1200,20230909,1180,20
すき家,埼玉県,すき家 桶川下日出谷店,埼玉県桶川市下日出谷西3-3-2,1100,20230909,1050,50
すき家,埼玉県,すき家 桶川加納店,埼玉県桶川市加納2149-1,1100,20230909,1050,50
すき家,山口県,すき家 下関赤間店,山口県下関市赤間町3-35,980,20230909,950,30
すき家,東京都,すき家 下石神井店,東京都練馬区下石神井5-16-3,1200,20230909,1100,100
すき家,東京都,すき家 下赤塚駅前店,東京都板橋区赤塚新町1-23-5プロスパービル上野1F,1200,20230909,1100,100
すき家,神奈川,すき家 下平間店,神奈川県川崎市幸区下平間274-11スズキハイツ1F,1200,20230909,1140,60
すき家,東京都,すき家 下北沢店,東京都世田谷区北沢2丁目12-7大町ビル,1200,20230909,1150,50
すき家,兵庫県,すき家 加古川東神吉店,兵庫県加古川市東神吉町西井ノ口284-1,1050,20230909,980,70
すき家,兵庫県,すき家 加古川平岡町店,兵庫県加古川市平岡町新在家418-2,1050,20230909,980,70
すき家,埼玉県,すき家 加須南大桑店,埼玉県加須市南大桑2877-1,1080,20230909,1030,50
すき家,兵庫県,すき家 加西北条店,兵庫県加西市北条町横尾294-1,1080,20230909,1000,80
すき家,東京都,すき家 花小金井駅北口店,東京都小平市花小金井1-9-18花小金井第一ビル1F,1200,20230909,1100,100
すき家,千葉県,すき家 我孫子寿店,千葉県我孫子市寿2-14-24,1080,20230909,1050,30
すき家,岐阜県,すき家 各務原蘇原店,岐阜県各務原市蘇原瑞穂町2-62-1,1080,20230909,1030,50
すき家,静岡県,すき家 掛川城西店,静岡県掛川市城西2-10-3,1080,20230909,1050,30
すき家,東京都,すき家 葛飾亀有一丁目店,東京都葛飾区亀有1-14-5,1160,20230909,1120,40
すき家,東京都,すき家 葛飾柴又店,東京都葛飾区柴又5-9-1,1160,20230909,1120,40
すき家,東京都,すき家 葛飾東新小岩店,東京都葛飾区東新小岩2-2-8,1160,20230909,1150,10
すき家,東京都,すき家 葛飾南水元店,東京都葛飾区南水元2-30-5,1160,20230909,1120,40
すき家,愛知県,すき家 蒲郡栄町店,愛知県蒲郡市栄町9-41,1080,20230909,1030,50
すき家,愛知県,すき家 蒲郡三谷北通店,愛知県蒲郡市三谷北通2-122,1080,20230909,1030,50
すき家,神奈川,すき家 鴨居駅北口店,神奈川県横浜市緑区鴨居1-15-13,1200,20230909,1140,60
すき家,福岡県,すき家 苅田店,福岡県京都郡苅田町尾倉1-3-1,1000,20230909,950,50
すき家,東京都,すき家 環七山王店,東京都大田区山王4-12-4,1250,20230909,1200,50
すき家,東京都,すき家 環七西新井店,東京都足立区西新井本町2-2-25,1160,20230909,1120,40
すき家,東京都,すき家 環七平和島店,東京都大田区大森本町2-30-2プレール大森EAST101号,1250,20230909,1200,50
すき家,東京都,すき家 環八羽田店,東京都大田区羽田4-3-3,1300,20230909,1200,100
すき家,東京都,すき家 環八蒲田四丁目店,東京都大田区蒲田4-42-12新生ビル1F,1250,20230909,1200,50
すき家,東京都,すき家 環八高井戸店,東京都杉並区高井戸西1-1-28,1200,20230909,1180,20
すき家,東京都,すき家 環八矢口渡店,東京都大田区多摩川1-7-11榎本ビル1F,1250,20230909,1200,50
すき家,千葉県,すき家 館山店,千葉県館山市安布里190-2,1100,20230909,1030,70
すき家,茨城県,すき家 岩井店,茨城県坂東市大字岩井字新畑4298-1,1050,20230909,1000,50
すき家,岐阜県,すき家 岐阜本荘店,岐阜県岐阜市鹿島町6-3-2,1080,20230909,1030,50
すき家,東京都,すき家 亀戸駅北口店,東京都江東区亀戸2-22-10カトウビル1F,1200,20230909,1150,50
すき家,沖縄県,すき家 宜野湾我如古店,沖縄県宜野湾市我如古4-7-3,960,20230909,930,30
すき家,埼玉県,すき家 久喜栗原店,埼玉県久喜市栗原2-2-5,1100,20230909,1050,50
すき家,東京都,すき家 久米川駅前店,東京都東村山市栄町2-9-32晃正プラザビル1F,1150,20230909,1100,50
すき家,福岡県,すき家 久留米国分店,福岡県久留米市国分町字御供田1604-7,980,20230909,950,30
すき家,富山県,すき家 魚津本江店,富山県魚津市本江字雲雀作2555-1,1080,20230909,1030,50
すき家,東京都,すき家 京王リトナード東府中店,東京都府中市清水ヶ丘1-8-3京王リトナード東府中1F,1150,20230909,1120,30
すき家,京都府,すき家 京田辺興戸店,京都府京田辺市興戸犬伏32-1,1050,20230909,1000,50
すき家,茨城県,すき家 境町上小橋店,茨城県猿島郡境町上小橋98-2,1050,20230909,1000,50
すき家,埼玉県,すき家 狭山広瀬店,埼玉県狭山市広瀬2-35-12,1100,20230909,1050,50
すき家,埼玉県,すき家 狭山富士見店,埼玉県狭山市富士見1-16-24,1100,20230909,1040,60
すき家,東京都,すき家 玉川学園駅前店,東京都町田市玉川学園7-5-2,1130,20230909,1100,30
すき家,兵庫県,すき家 玉津IC南店,兵庫県神戸市西区小山3-13-13,1080,20230909,1000,80
すき家,東京都,すき家 錦糸公園前店,東京都墨田区太平3-4-8グレイスMM1F,1200,20230909,1150,50
すき家,奈良県,すき家 近鉄奈良駅前店,奈良県奈良市中筋町6-1奈良ラインハウス1F,1000,20230909,950,50
すき家,石川県,すき家 金沢駅西本町店,石川県金沢市駅西本町6-3-7,1080,20230909,1030,50
すき家,石川県,すき家 金沢寺地店,石川県金沢市寺地1-32-28,1050,20230909,1030,20
すき家,石川県,すき家 金沢畝田店,石川県金沢市畝田中3-561,1080,20230909,1030,50
すき家,石川県,すき家 金沢増泉店,石川県金沢市増泉4-3-2,1050,20230909,1030,20
すき家,石川県,すき家 金沢大桑店,石川県金沢市大桑3-41,1050,20230909,1030,20
すき家,神奈川,すき家 駒岡店,神奈川県横浜市鶴見区駒岡1-27-4,1230,20230909,1140,90
すき家,東京都,すき家 駒沢大学前店,東京都世田谷区駒沢1-20-4,1250,20230909,1150,100
すき家,北海道,すき家 釧路桜ヶ岡店,北海道釧路市桜ヶ岡1-9-21,1000,20230909,950,50
すき家,埼玉県,すき家 熊谷BP店,埼玉県熊谷市上之4004-1,1080,20230909,1050,30
すき家,埼玉県,すき家 熊谷西店,埼玉県熊谷市新島261-2,1080,20230909,1000,80
すき家,埼玉県,すき家 熊谷籠原店,埼玉県熊谷市拾六間763-1,1080,20230909,1050,30
すき家,熊本県,すき家 熊本新市街店,熊本県熊本市中央区新市街7-25第二新世界会館ビル1F,980,20230909,960,20
すき家,熊本県,すき家 熊本東BP店,熊本県熊本市東区下南部3-17-71,970,20230909,950,20
すき家,熊本県,すき家 熊本野中店,熊本県熊本市西区野中1-6-12,1000,20230909,980,20
すき家,滋賀県,すき家 栗東大宝店,滋賀県栗東市霊仙寺3-8-32,1100,20230909,1080,20
すき家,千葉県,すき家 君津外箕輪店,千葉県君津市外箕輪3-17-21,1100,20230909,1050,50
すき家,千葉県,すき家 君津東坂田店,千葉県君津市東坂田2-3-13,1100,20230909,1050,50
すき家,茨城県,すき家 結城店,茨城県結城市大字結城9746-1,1050,20230909,1030,20
すき家,愛知県,すき家 犬山五郎丸店,愛知県犬山市五郎丸東3-7-1,1080,20230909,1050,30
すき家,神奈川,すき家 戸塚駅西口店,神奈川県横浜市戸塚区戸塚町4080-1LEON-K1F,1140,20230909,1090,50
すき家,神奈川,すき家 戸塚上倉田店,神奈川県横浜市戸塚区上倉田町1465-1,1160,20230909,1090,70
すき家,東京都,すき家 虎ノ門四丁目店,東京都港区虎ノ門4-1-19,1320,20230909,1280,40
すき家,千葉県,すき家 五香駅前店,千葉県松戸市常盤平5-11-12,1050,20230909,1020,30
すき家,東京都,すき家 五反野店,東京都足立区足立3-34-5沼野ビル,1160,20230909,1120,40
すき家,埼玉県,すき家 五領町店,埼玉県東松山市五領町15-15,1080,20230909,1050,30
すき家,広島県,すき家 呉広店,広島県呉市広中町1-21,1000,20230909,980,20
すき家,静岡県,すき家 御殿場店,静岡県御殿場市萩原809-2,1250,20230909,1200,50
すき家,東京都,すき家 御徒町駅南口店,東京都台東区上野5-27-2,1250,20230909,1200,50
すき家,埼玉県,すき家 幸手店,埼玉県幸手市中2-12-35,1080,20230909,1050,30
すき家,広島県,すき家 広大前店,広島県東広島市西条下見5-1-7,980,20230909,950,30
すき家,広島県,すき家 広島高取北店,広島県広島市安佐南区高取北1-2-32,1000,20230909,980,20
すき家,広島県,すき家 広島西風新都店,広島県広島市佐伯区石内北一丁目3-36,1000,20230909,980,20
すき家,広島県,すき家 広島丹那店,広島県広島市南区丹那町5-10,1050,20230909,1030,20
すき家,広島県,すき家 広島八丁堀店,広島県広島市中区八丁堀1-8エイトビル,1100,20230909,1080,20
すき家,広島県,すき家 広島緑井店,広島県広島市安佐南区緑井2-28-23,1000,20230909,980,20
すき家,東京都,すき家 江古田駅前店,東京都練馬区旭丘1-71-7土井ビル1F,1200,20230909,1100,100
すき家,東京都,すき家 江戸川興宮店,東京都江戸川区興宮町33-17,1160,20230909,1150,10
すき家,東京都,すき家 江東塩浜店,東京都江東区塩浜2-14-3,1250,20230909,1200,50
すき家,東京都,すき家 江東区役所前店,東京都江東区東陽4-10-7,1230,20230909,1200,30
すき家,東京都,すき家 江東新砂店,東京都江東区新砂3-2-6SGHレジデンス新砂1F,1230,20230909,1200,30
すき家,東京都,すき家 江東千石店,東京都江東区千石2-9-9,1230,20230909,1200,30
すき家,愛知県,すき家 江南大間店,愛知県江南市大間町新町159-1,1100,20230909,1050,50
すき家,東京都,すき家 港南四丁目店,東京都港区港南4-2-6,1350,20230909,1300,50
すき家,神奈川,すき家 港南台店,神奈川県横浜市港南区港南台4-3-1ビ-バ-ビル1F,1160,20230909,1090,70
すき家,東京都,すき家 港南二丁目店,東京都港区港南2-4-7石橋ビル1F,1350,20230909,1300,50
すき家,神奈川,すき家 港北小机店,神奈川県横浜市港北区小机町78-1,1250,20230909,1200,50
すき家,神奈川,すき家 港北箕輪町店,神奈川県横浜市港北区箕輪町2-5-5,1230,20230909,1180,50
すき家,東京都,すき家 甲州街道柴崎店,東京都調布市菊野台1-47-1,1200,20230909,1120,80
すき家,兵庫県,すき家 甲南店,兵庫県神戸市東灘区甲南町3-8-16,1050,20230909,1000,50
すき家,神奈川,すき家 綱島駅西口店,神奈川県横浜市港北区綱島西1-10-10第5吉田ビル1F,1230,20230909,1180,50
すき家,神奈川,すき家 綱島樽町店,神奈川県横浜市港北区樽町2-1-34,1230,20230909,1140,90
すき家,埼玉県,すき家 行田向町店,埼玉県行田市向町17-11,1070,20230909,1050,20
すき家,千葉県,すき家 行徳北店,千葉県市川市富浜3-2-24,1150,20230909,1110,40
すき家,東京都,すき家 高円寺駅南口店,東京都杉並区高円寺南4-45-2メインロードビル1F,1250,20230909,1180,70
すき家,富山県,すき家 高岡熊野店,富山県高岡市熊野町5-30,1080,20230909,1030,50
すき家,富山県,すき家 高岡中曽根店,富山県高岡市中曽根290-3,1080,20230909,1030,50
すき家,栃木県,すき家 高根沢店,栃木県塩谷郡高根沢町宝石台3-14-7,1050,20230909,980,70
すき家,兵庫県,すき家 高砂松陽店,兵庫県高砂市松陽1-7-15,1050,20230909,980,70
すき家,東京都,すき家 高田馬場駅北店,東京都豊島区高田3-15-7第1大島ビル1F,1250,20230909,1150,100
すき家,東京都,すき家 高田馬場店,東京都新宿区高田馬場1-28-4工新別館ビル,1250,20230909,1150,100
すき家,東京都,すき家 高島平駅前店,東京都板橋区高島平8-11-11SDビル,1200,20230909,1120,80
すき家,東京都,すき家 高幡不動駅店,東京都日野市高幡116-10京王高幡SC1階A106号区画,1130,20230909,1080,50
すき家,埼玉県,すき家 鴻巣鎌塚店,埼玉県鴻巣市鎌塚1775-6,1070,20230909,1050,20
すき家,埼玉県,すき家 鴻巣店,埼玉県鴻巣市天神1-7-6,1070,20230909,1050,20
すき家,東京都,すき家 豪徳寺駅前店,東京都世田谷区豪徳寺1-25-7ニ-ナロ-ジナビル,1250,20230909,1150,100
すき家,東京都,すき家 国分寺本多店,東京都国分寺市本多2-16-1,1130,20230909,1080,50
すき家,鹿児島,すき家 国分野口店,鹿児島県霧島市国分野口東6-16,1050,20230909,1000,50
すき家,愛媛県,すき家 今治衣干店,愛媛県今治市衣干町1942-4,1020,20230909,980,40
すき家,愛媛県,すき家 今治北日吉店,愛媛県今治市北日吉町3-5-53,1020,20230909,980,40
すき家,佐賀県,すき家 佐賀本庄店,佐賀県佐賀市本庄町袋305-2,950,20230909,920,30
すき家,千葉県,すき家 佐倉石川店,千葉県佐倉市石川535-6,1100,20230909,1050,50
すき家,千葉県,すき家 佐倉店,千葉県佐倉市王子台2-12-22,1100,20230909,1050,50
すき家,神奈川,すき家 座間広野台店,神奈川県座間市広野台1-25-5,1160,20230909,1110,50
すき家,埼玉県,すき家 坂戸にっさい店,埼玉県坂戸市にっさい花みず木3-19-3,1080,20230909,1050,30
すき家,埼玉県,すき家 坂戸塚越店,埼玉県坂戸市石井2901-3,1080,20230909,1050,30
すき家,兵庫県,すき家 阪急伊丹店,兵庫県伊丹市中央1-6-14,1080,20230909,1030,50
すき家,大阪府,すき家 堺筋恵美須町店,大阪府大阪市浪速区日本橋5-13-18フォレシティ日本橋V1F,1120,20230909,1070,50
すき家,東京都,すき家 桜上水駅前店,東京都世田谷区桜上水4-10-16間瀬ビル1F,1200,20230909,1120,80
すき家,東京都,すき家 桜新町駅前店,東京都世田谷区桜新町1-12-13第5吉田ビル1F,1250,20230909,1150,100
すき家,東京都,すき家 桜新道南大井店,東京都品川区南大井3-7-20,1250,20230909,1200,50
すき家,東京都,すき家 笹塚店,東京都渋谷区笹塚2-19-2TSK笹塚ビル,1200,20230909,1150,50
すき家,福井県,すき家 鯖江北野店,福井県鯖江市北野町18-11,1050,20230909,1000,50
すき家,東京都,すき家 三河島駅前店,東京都荒川区東日暮里6-1-1アトラスブランズタワー三河島1F,1200,20230909,1120,80
すき家,東京都,すき家 三軒茶屋二丁目店,東京都世田谷区三軒茶屋2-11-24サンタワ-ズA101,1300,20230909,1150,150
すき家,東京都,すき家 三軒茶屋北店,東京都世田谷区太子堂2-24-6ドミ-三軒茶屋1F,1300,20230909,1150,150
すき家,東京都,すき家 三鷹井口店,東京都三鷹市井口2-13-42,1200,20230909,1130,70
すき家,東京都,すき家 三鷹駅南口店,東京都三鷹市下連雀3-23-12ア-ジェントビル,1200,20230909,1120,80
すき家,東京都,すき家 三鷹牟礼店,東京都三鷹市牟礼4-8-7,1200,20230909,1120,80
すき家,東京都,すき家 三田店,東京都港区芝5-25-9,1350,20230909,1300,50
すき家,兵庫県,すき家 三木志染店,兵庫県三木市志染町広野1-263-1,1050,20230909,1000,50
すき家,兵庫県,すき家 三木本町店,兵庫県三木市本町1-6-30,1050,20230909,1000,50
すき家,山形県,すき家 山形城西店,山形県山形市城西町4-19-19,980,20230909,930,50
すき家,千葉県,すき家 四街道IC店,千葉県四街道市栗山812-6,1100,20230909,1080,20
すき家,千葉県,すき家 四街道鹿放ヶ丘店,千葉県四街道市鹿放ヶ丘459-1,1100,20230909,1080,20
すき家,千葉県,すき家 市原能満店,千葉県市原市能満4-8,1100,20230909,1070,30
すき家,神奈川,すき家 汐入店,神奈川県横浜市鶴見区仲通1-54アネックスつるみ102,1230,20230909,1160,70
すき家,鹿児島,すき家 鹿屋寿店,鹿児島県鹿屋市寿8-20-7,1050,20230909,1000,50
すき家,鹿児島,すき家 鹿児島卸本町店,鹿児島県鹿児島市卸本町6-2,1000,20230909,970,30
すき家,鹿児島,すき家 鹿児島天文館店,鹿児島県鹿児島市呉服町1-3センチュリオンホテル鹿児島1F,1000,20230909,950,50
すき家,東京都,すき家 柴又街道小岩店,東京都江戸川区東小岩6-3-5,1160,20230909,1150,10
すき家,東京都,すき家 芝浦四丁目店,東京都港区芝浦4-9-18グランドパレス田町1F,1350,20230909,1300,50
すき家,千葉県,すき家 芝山店,千葉県船橋市芝山2-9-1,1100,20230909,1050,50
すき家,東京都,すき家 芝四丁目店,東京都港区芝4-7-1西山ビル1F,1350,20230909,1300,50
すき家,山形県,すき家 酒田若竹店,山形県酒田市若竹町2-3-5,1080,20230909,1050,30
すき家,福岡県,すき家 宗像赤間店,福岡県宗像市赤間駅前2-2-19,980,20230909,920,60
すき家,東京都,すき家 秋葉原駅岩本町店,東京都千代田区岩本町3-3-5秋葉原SHビル1F,1250,20230909,1200,50
すき家,東京都,すき家 住吉新大橋通店,東京都江東区住吉2-2-7住吉Sビル1F,1200,20230909,1150,50
すき家,新潟県,すき家 十日町店,新潟県十日町市上島601-1,1080,20230909,1000,80
すき家,東京都,すき家 渋谷円山町店,東京都渋谷区円山町28-4大場ビル1F,1350,20230909,1300,50
すき家,東京都,すき家 渋谷桜丘店,東京都渋谷区桜丘町15-19,1350,20230909,1300,50
すき家,東京都,すき家 渋谷南平台店,東京都渋谷区南平台町1-10いちご南平台ビル1F,1350,20230909,1300,50
すき家,東京都,すき家 渋谷二丁目店,東京都渋谷区渋谷2-12-13八千代ビル1F,1350,20230909,1300,50
すき家,愛知県,すき家 春日井中央店,愛知県春日井市瑞穂通7-16-1,1100,20230909,1080,20
すき家,愛知県,すき家 春日井桃山店,愛知県春日井市桃山町3-224-2,1100,20230909,1080,20
すき家,埼玉県,すき家 所沢下安松店,埼玉県所沢市下安松1576-1,1100,20230909,1050,50
すき家,埼玉県,すき家 所沢下新井店,埼玉県所沢市下新井1454-3,1100,20230909,1050,50
すき家,東京都,すき家 曙橋店,東京都新宿区住吉町8-25,1200,20230909,1150,50
すき家,東京都,すき家 勝どき三丁目店,東京都中央区勝どき3-7-6,1250,20230909,1230,20
すき家,千葉県,すき家 勝田台駅南店,千葉県八千代市勝田台1-37-8スプリングⅡ1F,1100,20230909,1050,50
すき家,東京都,すき家 小金井中町店,東京都小金井市中町2-8-2,1150,20230909,1130,20
すき家,埼玉県,すき家 小手指駅北口店,埼玉県所沢市小手指町1-1-1,1080,20230909,1050,30
すき家,福岡県,すき家 小倉北神岳店,福岡県北九州市小倉北区神岳2-6-30,1000,20230909,950,50
すき家,北海道,すき家 小樽有幌店,北海道小樽市有幌町2-14,1000,20230909,980,20
すき家,東京都,すき家 小平上水本町店,東京都小平市上水本町4-12-7,1130,20230909,1120,10
すき家,東京都,すき家 小平中島町店,東京都小平市中島町22-19,1150,20230909,1100,50
すき家,東京都,すき家 小平鈴木店,東京都小平市鈴木町1-215-3,1150,20230909,1100,50
すき家,愛知県,すき家 小牧春日寺店,愛知県小牧市春日寺2-329,1080,20230909,1050,30
すき家,東京都,すき家 昭島駅南店,東京都昭島市昭和町5-14-17,1130,20230909,1080,50
すき家,千葉県,すき家 松戸駅西口店,千葉県松戸市本町19-23宝星ビル1F,1080,20230909,1050,30
すき家,千葉県,すき家 松戸古ヶ崎店,千葉県松戸市古ヶ崎764-1,1080,20230909,1050,30
すき家,千葉県,すき家 松戸秋山店,千葉県松戸市秋山1-8-8,1080,20230909,1050,30
すき家,千葉県,すき家 松戸中央店,千葉県松戸市南花島2-32-9,1080,20230909,1050,30
すき家,千葉県,すき家 松戸二十世紀が丘店,千葉県松戸市二十世紀が丘美野里町15-1,1080,20230909,1050,30
すき家,千葉県,すき家 松戸六高台店,千葉県松戸市六高台1-71,1080,20230909,1050,30
すき家,島根県,すき家 松江菅田店,島根県松江市菅田町24-1,980,20230909,950,30
すき家,静岡県,すき家 焼津小川店,静岡県焼津市東小川8-11-12,1050,20230909,1030,20
すき家,東京都,すき家 上石神井駅前店,東京都練馬区上石神井1-13-17,1200,20230909,1100,100
すき家,東京都,すき家 上池袋二丁目店,東京都豊島区上池袋2-40-10ニューキャッスル上池袋1F,1250,20230909,1200,50
すき家,東京都,すき家 上池台三丁目店,東京都大田区上池台3-13-3,1250,20230909,1150,100
すき家,埼玉県,すき家 上福岡駅前店,埼玉県ふじみ野市上福岡1-8-2森田ビル1F,1070,20230909,1040,30
すき家,神奈川,すき家 新横浜店,神奈川県横浜市港北区新横浜2-6-17,1250,20230909,1220,30
すき家,新潟県,すき家 新潟牡丹山店,新潟県新潟市東区牡丹山4-1-27,1030,20230909,950,80
すき家,新潟県,すき家 新潟河渡店,新潟県新潟市東区河渡庚252-1,1030,20230909,950,80
すき家,新潟県,すき家 新潟小針店,新潟県新潟市西区小針2-38-12,1030,20230909,950,80
すき家,東京都,すき家 新橋三丁目店,東京都港区新橋3-10-9ホテル新橋三番館1F,1280,20230909,1250,30
すき家,東京都,すき家 新御徒町店,東京都台東区東上野1-1-1,1250,20230909,1200,50
すき家,東京都,すき家 新高円寺東店,東京都杉並区梅里1-7-17,1200,20230909,1180,20
すき家,東京都,すき家 新高島平駅南店,東京都板橋区高島平4-23-17アルテ-ル藤久,1200,20230909,1120,80
すき家,埼玉県,すき家 新座駅前店,埼玉県新座市野火止5-3-11,1100,20230909,1030,70
すき家,埼玉県,すき家 新座大和田店,埼玉県新座市大和田4-14-7,1100,20230909,1050,50
すき家,埼玉県,すき家 新座道場店,埼玉県新座市道場2-18-9ラークアベニュータガイ1F,1100,20230909,1050,50
すき家,埼玉県,すき家 新座野火止店,埼玉県新座市野火止3-15-19,1100,20230909,1050,50
すき家,千葉県,すき家 新習志野店,千葉県習志野市茜浜2-1-12,1100,20230909,1050,50
すき家,東京都,すき家 新宿NSビル店,東京都新宿区西新宿2-4-1新宿NSビル1F,1320,20230909,1300,20
すき家,東京都,すき家 新宿御苑前駅店,東京都新宿区新宿1-19-7新花ビル1F,1300,20230909,1200,100
すき家,東京都,すき家 新宿南店,東京都新宿区新宿3-32-2,1320,20230909,1250,70
すき家,東京都,すき家 新宿二丁目店,東京都新宿区新宿2-15-15新宿ヤマトビル1F,1300,20230909,1220,80
すき家,東京都,すき家 新宿六丁目店,東京都新宿区新宿6-28-10,1300,20230909,1200,100
すき家,東京都,すき家 新小岩店,東京都葛飾区西新小岩1-9-7,1160,20230909,1150,10
すき家,千葉県,すき家 新松戸店,千葉県松戸市新松戸3-271神谷第一ビル,1080,20230909,1050,30
すき家,東京都,すき家 新青梅街道花小金井店,東京都小平市花小金井3-21-14,1150,20230909,1100,50
すき家,東京都,すき家 新青梅街道東村山店,東京都東村山市富士見町3-2-1,1150,20230909,1100,50
すき家,東京都,すき家 新木場駅南店,東京都江東区新木場1-4-7,1280,20230909,1250,30
すき家,東京都,すき家 森下店,東京都江東区森下2-18-8,1250,20230909,1150,100
すき家,東京都,すき家 神宮前三丁目店,東京都渋谷区神宮前3-23-3トリニティビル1F,1350,20230909,1300,50
すき家,東京都,すき家 神保町駅前店,東京都千代田区神田神保町1-14KDX神保町ビル1F,1250,20230909,1150,100
すき家,茨城県,すき家 水海道店,茨城県常総市新井木町字江畑102-3,1050,20230909,1000,50
すき家,東京都,すき家 水道橋駅東口店,東京都千代田区神田三崎町1-4-26,1250,20230909,1150,100
すき家,東京都,すき家 瑞江店,東京都江戸川区瑞江2-1-23田所ビル1F,1160,20230909,1120,40
すき家,静岡県,すき家 裾野二ツ屋店,静岡県裾野市二ツ屋155-1,1100,20230909,1050,50
すき家,東京都,すき家 世田谷赤堤通り店,東京都世田谷区桜上水2-1-8,1200,20230909,1150,50
すき家,愛知県,すき家 瀬戸店,愛知県瀬戸市高根町1-68,1080,20230909,1050,30
すき家,岡山県,すき家 瀬戸内邑久店,岡山県瀬戸内市邑久町豊原90-3,1000,20230909,980,20
すき家,東京都,すき家 成城学園駅前店,東京都世田谷区成城2-35-12,1250,20230909,1150,100
すき家,東京都,すき家 成増店,東京都板橋区成増2-18-7吉田屋第一ビル1F,1200,20230909,1100,100
すき家,千葉県,すき家 成田江弁須店,千葉県成田市江弁須490-16,1200,20230909,1140,60
すき家,千葉県,すき家 成田取香店,千葉県成田市取香529-1,1280,20230909,1250,30
すき家,千葉県,すき家 成田東店,千葉県成田市寺台28-1,1200,20230909,1140,60
すき家,東京都,すき家 晴海二丁目店,東京都中央区晴海2-5-24晴海センタービル1F,1250,20230909,1230,20
すき家,静岡県,すき家 清水鳥坂店,静岡県静岡市清水区鳥坂1231-1,1080,20230909,1000,80
すき家,岩手県,すき家 盛岡西店,岩手県盛岡市本宮3-5-10,950,20230909,900,50
すき家,岩手県,すき家 盛岡青山店,岩手県盛岡市青山3-7-1,930,20230909,900,30
すき家,東京都,すき家 西永福店,東京都杉並区永福3-56-30,1150,20230909,1120,30
すき家,東京都,すき家 西葛西一丁目店,東京都江戸川区西葛西1-15-9スカイビル,1200,20230909,1150,50
すき家,東京都,すき家 西葛西駅前店,東京都江戸川区西葛西6-8-11葛西産業ビル,1200,20230909,1150,50
すき家,兵庫県,すき家 西宮今津巽店,兵庫県西宮市今津巽町4-37,1080,20230909,1030,50
すき家,東京都,すき家 西五反田一丁目店,東京都品川区西五反田1-24-4タキゲンビル1F,1300,20230909,1200,100
すき家,東京都,すき家 西五反田七丁目店,東京都品川区西五反田7-13-5DK五反田ビル,1300,20230909,1200,100
すき家,東京都,すき家 西国分寺駅前店,東京都国分寺市西恋ヶ窪2-5-1積丹ビル1F,1150,20230909,1080,70
すき家,東京都,すき家 西新宿五丁目駅前店,東京都新宿区西新宿4-3-12渡辺西新宿ビル1F,1300,20230909,1200,100
すき家,東京都,すき家 西新宿小滝橋通り店,東京都新宿区西新宿7-10-16千徳ビル,1300,20230909,1200,100
すき家,千葉県,すき家 西千葉駅前店,千葉県千葉市中央区春日2-25-1竹久ビル1F,1080,20230909,1050,30
すき家,千葉県,すき家 西船橋店,千葉県船橋市山野町10-1,1100,20230909,1050,50
すき家,東京都,すき家 西台駅西店,東京都板橋区高島平1-75-15高桐マンション1F,1200,20230909,1120,80
すき家,福岡県,すき家 西鉄久留米駅前店,福岡県久留米市東町1-5,980,20230909,950,30
すき家,東京都,すき家 西日暮里一丁目店,東京都荒川区西日暮里1-1-1パレスいしかわ1F,1200,20230909,1120,80
すき家,神奈川,すき家 西武東戸塚S.C.店,神奈川県横浜市戸塚区品濃町537-1,1200,20230909,1090,110
すき家,大阪府,すき家 西淀川大和田店,大阪府大阪市西淀川区大和田2-1-17,1100,20230909,1080,20
すき家,東京都,すき家 青梅河辺店,東京都青梅市河辺町5-25-1,1130,20230909,1080,50
すき家,東京都,すき家 青梅新町店,東京都青梅市新町7-6-10,1130,20230909,1080,50
すき家,静岡県,すき家 静岡下川原店,静岡県静岡市駿河区下川原3-34-7,1100,20230909,1030,70
すき家,静岡県,すき家 静岡国吉田店,静岡県静岡市駿河区国吉田4-2-20,1100,20230909,1030,70
すき家,静岡県,すき家 静岡松富店,静岡県静岡市葵区松富2-1-51,1100,20230909,1030,70
すき家,静岡県,すき家 静岡八幡店,静岡県静岡市駿河区八幡2-14-16,1100,20230909,1030,70
すき家,静岡県,すき家 静岡流通通り店,静岡県静岡市葵区千代田7-9-25,1100,20230909,1050,50
すき家,東京都,すき家 赤羽南口店,東京都北区赤羽1-1-24,1200,20230909,1120,80
すき家,東京都,すき家 赤坂六丁目店,東京都港区赤坂6-3-1アスモビル,1320,20230909,1280,40
すき家,兵庫県,すき家 摂津本山駅前店,兵庫県神戸市東灘区岡本1-3-33,1050,20230909,1000,50
すき家,東京都,すき家 仙川店,東京都調布市仙川町1-11-13大平ビル1F,1180,20230909,1120,60
すき家,宮城県,すき家 仙台岩切店,宮城県仙台市宮城野区岩切字青津目8-1,980,20230909,930,50
すき家,宮城県,すき家 仙台松森店,宮城県仙台市泉区松森字陣ヶ原5-1,980,20230909,930,50
すき家,宮城県,すき家 仙台水の森店,宮城県仙台市青葉区水の森3-31-1,950,20230909,930,20
すき家,宮城県,すき家 仙台泉中央店,宮城県仙台市泉区泉中央1-1-4,950,20230909,930,20
すき家,東京都,すき家 千歳船橋駅前店,東京都世田谷区船橋1-9-24千歳船橋振興組合会館1F,1200,20230909,1150,50
すき家,東京都,すき家 千川駅前店,東京都豊島区要町3-10-10,1200,20230909,1100,100
すき家,千葉県,すき家 千葉貝塚店,千葉県千葉市若葉区貝塚2-10-1,1080,20230909,1050,30
すき家,千葉県,すき家 千葉小倉店,千葉県千葉市若葉区小倉町862-3,1080,20230909,1050,30
すき家,千葉県,すき家 千葉蘇我店,千葉県千葉市中央区南町1-2-9,1080,20230909,1050,30
すき家,埼玉県,すき家 川越笠幡店,埼玉県川越市笠幡181-1,1080,20230909,1040,40
すき家,埼玉県,すき家 川越諏訪町店,埼玉県川越市諏訪町16-13,1080,20230909,1050,30
すき家,埼玉県,すき家 川越氷川町店,埼玉県川越市氷川町29-1,1100,20230909,1090,10
すき家,埼玉県,すき家 川越木野目店,埼玉県川越市木野目1560-1,1080,20230909,1050,30
すき家,神奈川,すき家 川崎駅前大通り店,神奈川県川崎市川崎区砂子2-6-27横山ビル1F,1250,20230909,1220,30
すき家,神奈川,すき家 川崎下麻生店,神奈川県川崎市麻生区下麻生3-46-6,1200,20230909,1140,60
すき家,神奈川,すき家 川崎今井店,神奈川県川崎市中原区今井西町1-56,1200,20230909,1140,60
すき家,神奈川,すき家 川崎宿河原店,神奈川県川崎市多摩区宿河原4-2-2,1200,20230909,1140,60
すき家,東京都,すき家 浅草橋駅前店,東京都台東区柳橋1-23-3田中ビル1F,1250,20230909,1150,100
すき家,東京都,すき家 浅草六区店,東京都台東区浅草2-9-14木村ビル1F,1250,20230909,1150,100
すき家,千葉県,すき家 船橋夏見台店,千葉県船橋市夏見台5-9-1,1100,20230909,1050,50
すき家,千葉県,すき家 船橋古作店,千葉県船橋市古作2-1-1,1080,20230909,1050,30
すき家,千葉県,すき家 船橋三咲店,千葉県船橋市三咲4-19-1,1080,20230909,1050,30
すき家,千葉県,すき家 船橋習志野店,千葉県船橋市習志野5-5-1,1080,20230909,1050,30
すき家,千葉県,すき家 船橋南店,千葉県船橋市浜町1-41-10第3土井ビル1F,1100,20230909,1050,50
すき家,千葉県,すき家 船橋日大前店,千葉県船橋市坪井東1-2-38,1080,20230909,1050,30
すき家,東京都,すき家 船堀駅前店,東京都江戸川区船堀3-5-7船堀駅前トキビル1F,1160,20230909,1120,40
すき家,群馬県,すき家 前橋堀越店,群馬県前橋市堀越町366-1,1050,20230909,1000,50
すき家,群馬県,すき家 前橋野中町店,群馬県前橋市野中町50-1,1050,20230909,1000,50
すき家,鳥取県,すき家 倉吉伊木店,鳥取県倉吉市伊木241-18,1000,20230909,950,50
すき家,岡山県,すき家 倉敷下庄店,岡山県倉敷市下庄619-5,1000,20230909,950,50
すき家,岡山県,すき家 倉敷田ノ上店,岡山県倉敷市田ノ上939-1,1050,20230909,1000,50
すき家,岡山県,すき家 倉敷連島店,岡山県倉敷市連島2-9-18,1000,20230909,980,20
すき家,兵庫県,すき家 相生垣内店,兵庫県相生市垣内町1310-7,1030,20230909,1000,30
すき家,神奈川,すき家 相模原上鶴間店,神奈川県相模原市南区上鶴間2-7-2,1160,20230909,1090,70
すき家,神奈川,すき家 相模大野駅南口店,神奈川県相模原市南区相模大野8-2-6第一島ビル1F,1140,20230909,1090,50
すき家,東京都,すき家 蔵前駅前店,東京都台東区蔵前2-6-6,1250,20230909,1150,100
すき家,栃木県,すき家 足利葉鹿店,栃木県足利市葉鹿町1-29-3,1030,20230909,1000,30
すき家,東京都,すき家 足立一ツ家店,東京都足立区一ツ家1-15-6,1160,20230909,1120,40
すき家,東京都,すき家 足立栗原店,東京都足立区栗原4-9-6荒堀ビル1F,1160,20230909,1120,40
すき家,東京都,すき家 足立鹿浜店,東京都足立区鹿浜2-34-17,1160,20230909,1120,40
すき家,東京都,すき家 足立西綾瀬店,東京都足立区西綾瀬3-11-13,1160,20230909,1120,40
すき家,東京都,すき家 足立扇店,東京都足立区扇2-26-42,1160,20230909,1120,40
すき家,東京都,すき家 足立入谷店,東京都足立区入谷7-1-7フーファイゼンハウス1F,1160,20230909,1120,40
すき家,東京都,すき家 足立六木店,東京都足立区六木2-7-8,1160,20230909,1120,40
すき家,東京都,すき家 多摩乞田店,東京都多摩市乞田791-1,1140,20230909,1120,20
すき家,福岡県,すき家 太宰府向佐野店,福岡県太宰府市向佐野3-3-35,1000,20230909,950,50
すき家,群馬県,すき家 太田中央店,群馬県太田市下浜田町1369-1,1050,20230909,1010,40
すき家,群馬県,すき家 太田内ヶ島店,群馬県太田市内ヶ島町1492-5,1050,20230909,1010,40
すき家,群馬県,すき家 太田南矢島店,群馬県太田市南矢島町928-1,1050,20230909,1010,40
すき家,群馬県,すき家 太田尾島店,群馬県太田市阿久津町113-1,1050,20230909,1040,10
すき家,東京都,すき家 台東下谷店,東京都台東区下谷3-19-8,1200,20230909,1150,50
すき家,東京都,すき家 大井町一丁目店,東京都品川区大井1-16-2ブリリア大井町ラヴィアンタワ-1F,1250,20230909,1200,50
すき家,東京都,すき家 大久保二丁目店,東京都新宿区大久保2-6-18,1250,20230909,1200,50
すき家,東京都,すき家 大久保百人町店,東京都新宿区百人町1-16-14マキバビル1F,1250,20230909,1200,50
すき家,埼玉県,すき家 大宮清河寺店,埼玉県さいたま市西区清河寺字須場1232-5,1120,20230909,1100,20
すき家,千葉県,すき家 大原店,千葉県いすみ市大原9539-1,1050,20230909,1030,20
すき家,東京都,すき家 大山東町店,東京都板橋区大山東町22-8,1200,20230909,1120,80
すき家,東京都,すき家 大森ベルポート店,東京都品川区南大井6-26-3大森ベルポートD館1F,1250,20230909,1150,100
すき家,東京都,すき家 大森駅西口店,東京都大田区山王2-4-4,1250,20230909,1200,50
すき家,東京都,すき家 大森町駅前店,東京都大田区大森西3-25-7エストジュール大森町1F、2F,1250,20230909,1200,50
すき家,東京都,すき家 大森北三丁目店,東京都大田区大森北3-1-13,1250,20230909,1150,100
すき家,神奈川,すき家 大船駅前店,神奈川県鎌倉市大船1-5-9イトービル1F,1140,20230909,1090,50
すき家,東京都,すき家 大鳥居店,東京都大田区西糀谷3-21-2,1250,20230909,1200,50
すき家,東京都,すき家 大田久が原店,東京都大田区久が原5-3-6,1250,20230909,1180,70
すき家,東京都,すき家 大田東邦医大通店,東京都大田区大森西1-8-17,1250,20230909,1200,50
すき家,東京都,すき家 大田南六郷店,東京都大田区南六郷2-34-7,1250,20230909,1200,50
すき家,愛知県,すき家 大府長草店,愛知県大府市柊山町3-389,1100,20230909,1030,70
すき家,大分県,すき家 大分日岡店,大分県大分市日岡1-3-22,950,20230909,920,30
すき家,神奈川,すき家 大和りんかんモール店,神奈川県大和市中央林間7丁目6-1,1140,20230909,1110,30
すき家,神奈川,すき家 大和駅北口店,神奈川県大和市大和東1-3-12,1140,20230909,1090,50
すき家,奈良県,すき家 大和高田神楽店,奈良県大和高田市神楽280-2,1000,20230909,970,30
すき家,神奈川,すき家 大和中央店,神奈川県大和市深見西2-4-3,1160,20230909,1090,70
すき家,東京都,すき家 第一京浜鮫洲店,東京都品川区東大井4-7-11,1250,20230909,1200,50
すき家,愛知県,すき家 知多つつじが丘店,愛知県知多市つつじが丘1-19-11,1100,20230909,1030,70
すき家,東京都,すき家 池上通り中央店,東京都大田区中央7-3-1カバヤビル1F,1250,20230909,1200,50
すき家,東京都,すき家 池袋サンシャイン前店,東京都豊島区東池袋4-25-9タイムズステーション池袋,1250,20230909,1200,50
すき家,東京都,すき家 池袋西店,東京都豊島区西池袋2-39-11,1250,20230909,1200,50
すき家,東京都,すき家 築地四丁目店,東京都中央区築地4-12-2シグネットビル1F,1250,20230909,1230,20
すき家,東京都,すき家 竹芝店,東京都港区海岸1-9-11,1350,20230909,1300,50
すき家,東京都,すき家 中葛西店,東京都江戸川区中葛西6-1-10メゾンド佐久間Ⅱ,1160,20230909,1150,10
すき家,埼玉県,すき家 朝霞駅東口店,埼玉県朝霞市仲町2-2-34工房朝霞ビル1F,1100,20230909,1080,20
すき家,埼玉県,すき家 朝霞駅南口店,埼玉県朝霞市本町2-3-18,1100,20230909,1080,20
すき家,埼玉県,すき家 朝霞朝志ヶ丘店,埼玉県朝霞市朝志ヶ丘4-7-19ア-ルフォンティ-ヌ1F,1080,20230909,1040,40
すき家,福岡県,すき家 朝倉甘木店,福岡県朝倉市一木626-1,1000,20230909,950,50
すき家,東京都,すき家 潮見店,東京都江東区潮見2-10-22,1250,20230909,1230,20
すき家,東京都,すき家 町田高ヶ坂店,東京都町田市高ヶ坂6-4-1,1140,20230909,1120,20
すき家,東京都,すき家 町田小山店,東京都町田市小山町959-1,1130,20230909,1100,30
すき家,東京都,すき家 町田能ヶ谷店,東京都町田市能ヶ谷町7-12-11,1140,20230909,1120,20
すき家,東京都,すき家 調布入間店,東京都調布市入間町2-4-1,1180,20230909,1120,60
すき家,千葉県,すき家 銚子店,千葉県銚子市長塚町1-465-1,1080,20230909,1050,30
すき家,東京都,すき家 長原駅東店,東京都大田区上池台1-44-1ライオンズマンション102,1250,20230909,1150,100
すき家,長崎県,すき家 長崎大学前店,長崎県長崎市家野町1-5,950,20230909,900,50
すき家,長崎県,すき家 長崎銅座町店,長崎県長崎市銅座町6-1銅座松尾ビル1F,1000,20230909,970,30
すき家,岡山県,すき家 津山小田中店,岡山県津山市小田中1301-1,1000,20230909,980,20
すき家,香川県,すき家 津田の松原SA下り店,香川県さぬき市津田町鶴羽939-1,950,20230909,920,30
すき家,香川県,すき家 津田の松原SA上り店,香川県さぬき市津田町鶴羽935-5,950,20230909,920,30
すき家,山形県,すき家 鶴岡道形店,山形県鶴岡市道形字二ツ屋61-2,1080,20230909,1050,30
すき家,埼玉県,すき家 鶴瀬駅西口店,埼玉県富士見市鶴馬2602-2鶴瀬駅西口ビル1F,1080,20230909,1040,40
すき家,北海道,すき家 登別新生町店,北海道登別市新生町4-16-4,1000,20230909,980,20
すき家,神奈川,すき家 都筑ふれあいの丘店,神奈川県横浜市都筑区荏田南1-1,1250,20230909,1200,50
すき家,静岡県,すき家 島田中河町店,静岡県島田市中河町8992-2,1080,20230909,1030,50
すき家,東京都,すき家 東雲晴海通り店,東京都江東区東雲1-6-17,1250,20230909,1230,20
すき家,愛知県,すき家 東海加木屋店,愛知県東海市加木屋町大清水77-1,1080,20230909,1030,50
すき家,愛知県,すき家 東海大池公園店,愛知県東海市富貴ノ台6-129,1100,20230909,1030,70
すき家,茨城県,すき家 東海店,茨城県那珂郡東海村村松1151-6,1020,20230909,1000,20
すき家,東京都,すき家 東久留米下里店,東京都東久留米市下里2-6-7,1150,20230909,1100,50
すき家,東京都,すき家 東京駅京橋店,東京都中央区京橋1-1-9レオ八重洲ビル,1300,20230909,1250,50
すき家,千葉県,すき家 東金BP店,千葉県東金市田間846-5,1080,20230909,1050,30
すき家,広島県,すき家 東広島御薗宇店,広島県東広島市西条町御薗宇下上戸6487-1,1000,20230909,980,20
すき家,広島県,すき家 東広島八本松店,広島県東広島市八本松東2-10-8,1000,20230909,980,20
すき家,東京都,すき家 東高円寺駅前店,東京都杉並区高円寺南1-7-1陽輪台高円寺1F,1200,20230909,1180,20
すき家,東京都,すき家 東十条三丁目店,東京都北区東十条3-15-12シティハイツ東十条103,1200,20230909,1150,50
すき家,埼玉県,すき家 東松山店,埼玉県東松山市上野本1164-1,1080,20230909,1050,30
すき家,東京都,すき家 東村山秋津店,東京都東村山市秋津町3-47-3,1150,20230909,1100,50
すき家,東京都,すき家 東池袋五丁目店,東京都豊島区東池袋5-7-7金誠堂ビル1F,1250,20230909,1200,50
すき家,東京都,すき家 東池袋店,東京都豊島区東池袋1-31-1バロックコート101号室,1250,20230909,1200,50
すき家,東京都,すき家 等々力駅前店,東京都世田谷区等々力3-5-6,1200,20230909,1150,50
すき家,神奈川,すき家 藤が丘駅前店,神奈川県横浜市青葉区藤が丘2-5-1,1140,20230909,1090,50
すき家,静岡県,すき家 藤枝田沼店,静岡県藤枝市田沼4-7-10,1050,20230909,1000,50
すき家,奈良県,すき家 奈良七条店,奈良県奈良市七条町164-1,1000,20230909,950,50
すき家,奈良県,すき家 奈良富雄店,奈良県奈良市三碓7-1-23,1000,20230909,930,70
すき家,沖縄県,すき家 那覇真嘉比店,沖縄県那覇市真嘉比3-15-16,1000,20230909,980,20
すき家,東京都,すき家 南葛西店,東京都江戸川区南葛西2-2-2第2サクマビル1F,1200,20230909,1150,50
すき家,山口県,すき家 南岩国店,山口県岩国市尾津町2-20-33,1000,20230909,980,20
すき家,大阪府,すき家 南港ATC店,大阪府大阪市住之江区南港北2-1-10O&#x27;s215区画,1200,20230909,1120,80
すき家,東京都,すき家 南砂店,東京都江東区南砂5-14-6サーハンビル,1200,20230909,1150,50
すき家,宮城県,すき家 南仙台柳生店,宮城県仙台市太白区柳生1-3-9,960,20230909,930,30
すき家,滋賀県,すき家 南草津店,滋賀県草津市野路6-8-22,1050,20230909,1030,20
すき家,兵庫県,すき家 南塚口七丁目店,兵庫県尼崎市南塚口町7-6-19,1050,20230909,1030,20
すき家,兵庫県,すき家 南武庫之荘店,兵庫県尼崎市南武庫之荘4-19-10,1050,20230909,1030,20
すき家,千葉県,すき家 南流山店,千葉県流山市南流山7-1-10,1080,20230909,1050,30
すき家,東京都,すき家 二子玉川駅前店,東京都世田谷区玉川2-22-13,1200,20230909,1150,50
すき家,兵庫県,すき家 尼崎浜田店,兵庫県尼崎市浜田4-41-1,1050,20230909,1030,20
すき家,東京都,すき家 日の出IC店,東京都西多摩郡日の出町平井15-16,1150,20230909,1120,30
すき家,埼玉県,すき家 日高鹿山店,埼玉県日高市鹿山247-5,1080,20230909,1030,50
すき家,東京都,すき家 日本橋小伝馬町店,東京都中央区日本橋小伝馬町15-18EDGE小伝馬町ビル1F,1250,20230909,1200,50
すき家,東京都,すき家 日野大坂上店,東京都日野市大坂上1-29-2-1,1130,20230909,1080,50
すき家,東京都,すき家 日野南平店,東京都日野市南平4-40-1,1130,20230909,1080,50
すき家,茨城県,すき家 日立田尻店,茨城県日立市田尻町4-6-7,1020,20230909,980,40
すき家,千葉県,すき家 馬込沢駅前店,千葉県船橋市藤原7-2-2Lｕｚ船橋1F,1100,20230909,1030,70
すき家,東京都,すき家 梅屋敷駅東店,東京都大田区東蒲田1-1-1プラムパーク嶋田1F,1250,20230909,1200,50
すき家,福岡県,すき家 博多駅前四丁目店,福岡県福岡市博多区博多駅前4-3-22産恵ビル1F,1000,20230909,980,20
すき家,千葉県,すき家 柏篠籠田店,千葉県流山市駒木205-1,1070,20230909,1050,20
すき家,千葉県,すき家 柏増尾台店,千葉県柏市増尾台4-13-4,1100,20230909,1050,50
すき家,東京都,すき家 幡ヶ谷駅前店,東京都渋谷区幡ヶ谷1-33-1シャト-フタバ1F,1200,20230909,1150,50
すき家,東京都,すき家 八王子みなみ野駅前店,東京都八王子市みなみ野1-3-1,1130,20230909,1080,50
すき家,東京都,すき家 八王子小宮店,東京都八王子市小宮町924-1,1130,20230909,1080,50
すき家,東京都,すき家 八王子東町店,東京都八王子市東町5-5,1130,20230909,1080,50
すき家,東京都,すき家 八王子楢原店,東京都八王子市楢原町397-5,1130,20230909,1080,50
すき家,東京都,すき家 八王子南店,東京都八王子市越野25-34,1130,20230909,1080,50
すき家,東京都,すき家 八王子平岡店,東京都八王子市平岡町25-2,1130,20230909,1080,50
すき家,東京都,すき家 八王子椚田店,東京都八王子市椚田町580-2メゾンくぬぎだ1F,1130,20230909,1080,50
すき家,千葉県,すき家 八街稲荷丘店,千葉県八街市八街ほ945-84,1080,20230909,1050,30
すき家,千葉県,すき家 八千代高津店,千葉県八千代市高津東1-6-18,1080,20230909,1050,30
すき家,千葉県,すき家 八千代村上店,千葉県八千代市村上南3-2-4,1080,20230909,1050,30
すき家,東京都,すき家 八丁堀四丁目店,東京都中央区八丁堀4-8-2いちご桜橋ビル1F,1280,20230909,1220,60
すき家,埼玉県,すき家 八潮西袋店,埼玉県八潮市西袋1030-1,1080,20230909,1050,30
すき家,埼玉県,すき家 八潮南川崎店,埼玉県八潮市南川崎590-1,1100,20230909,1050,50
すき家,千葉県,すき家 八日市場店,千葉県匝瑳市八日市場イ194-1,1100,20230909,1050,50
すき家,福岡県,すき家 八幡東枝光店,福岡県北九州市八幡東区枝光1-5,1000,20230909,950,50
すき家,愛知県,すき家 半田州の崎店,愛知県半田市州の崎町2-182,1100,20230909,1030,70
すき家,福岡県,すき家 飯塚市役所前店,福岡県飯塚市新飯塚20-24,950,20230909,920,30
すき家,静岡県,すき家 磐田一言店,静岡県磐田市一言2626-1,1050,20230909,1030,20
すき家,静岡県,すき家 磐田二之宮店,静岡県磐田市二之宮332-1,1050,20230909,1030,20
すき家,東京都,すき家 飛田給店,東京都調布市飛田給1-23-38荒井ビル,1180,20230909,1120,60
すき家,愛知県,すき家 尾西篭屋店,愛知県一宮市篭屋1-2-22,1100,20230909,1080,20
すき家,岐阜県,すき家 美濃加茂山手店,岐阜県美濃加茂市山手町2-20,1050,20230909,1000,50
すき家,徳島県,すき家 美馬脇町店,徳島県美馬市脇町大字猪尻字東分63-1,1020,20230909,950,70
すき家,京都府,すき家 百万遍店,京都府京都市左京区田中門前町28-20ドムス百万遍,1050,20230909,1000,50
すき家,東京都,すき家 氷川台駅前店,東京都練馬区氷川台3-40-15氷川ガ-デンハウス1F,1200,20230909,1100,100
すき家,東京都,すき家 品川シーサイド店,東京都品川区東品川4-12-4品川シーサイドパークタワー1階,1350,20230909,1300,50
すき家,東京都,すき家 品川東店,東京都港区港南2-2-3Mビル1F,1350,20230909,1300,50
すき家,静岡県,すき家 浜松駅南口店,静岡県浜松市中区砂山町324-8第一伊藤ビル1F,1050,20230909,1030,20
すき家,静岡県,すき家 浜松三方原店,静岡県浜松市北区三方原町795-5,1050,20230909,1030,20
すき家,静岡県,すき家 浜松志都呂店,静岡県浜松市西区志都呂2-20-24,1080,20230909,1030,50
すき家,静岡県,すき家 浜松西IC店,静岡県浜松市西区湖東町5926-2,1080,20230909,1030,50
すき家,静岡県,すき家 浜松鍛冶町店,静岡県浜松市中区鍛冶町320-20有楽ビル1F,1050,20230909,1030,20
すき家,静岡県,すき家 浜松頭陀寺店,静岡県浜松市南区頭陀寺町332-19,1050,20230909,1030,20
すき家,静岡県,すき家 浜松入野店,静岡県浜松市西区入野町6148-1,1050,20230909,1030,20
すき家,静岡県,すき家 浜北美薗店,静岡県浜松市浜北区西美薗2519-2,1050,20230909,1030,20
すき家,東京都,すき家 不動前駅西店,東京都品川区西五反田4-29-14オザワSANTビル1F,1250,20230909,1200,50
すき家,富山県,すき家 富山掛尾店,富山県富山市掛尾町401-3,1080,20230909,1030,50
すき家,富山県,すき家 富山呉羽店,富山県富山市本郷東部9-1,1080,20230909,1030,50
すき家,富山県,すき家 富山中川原店,富山県富山市秋吉194-9,1080,20230909,1030,50
すき家,山梨県,すき家 富士吉田赤富士通り店,山梨県富士吉田市上吉田東2丁目1-50,1100,20230909,1000,100
すき家,埼玉県,すき家 富士見下南畑店,埼玉県富士見市下南畑字島崎5006-4,1100,20230909,1050,50
すき家,埼玉県,すき家 富士見鶴瀬店,埼玉県富士見市上沢1-18-60,1100,20230909,1040,60
すき家,静岡県,すき家 富士柚木店,静岡県富士市柚木310-1,1050,20230909,1030,20
すき家,千葉県,すき家 富里店,千葉県富里市七栄439-1,1150,20230909,1140,10
すき家,東京都,すき家 府中けやき並木通り店,東京都府中市宮西町2-21F,1150,20230909,1120,30
すき家,東京都,すき家 府中栄店,東京都府中市栄町2-22-1,1150,20230909,1120,30
すき家,東京都,すき家 府中浅間店,東京都府中市浅間町4-19-1,1150,20230909,1120,30
すき家,東京都,すき家 府中本宿店,東京都府中市本宿町4-29-1,1150,20230909,1120,30
すき家,愛知県,すき家 扶桑柏森店,愛知県丹羽郡扶桑町大字柏森字西屋敷156-1,1080,20230909,1050,30
すき家,東京都,すき家 武蔵境北口店,東京都武蔵野市境2-3-26,1130,20230909,1100,30
すき家,東京都,すき家 武蔵小金井南口店,東京都小金井市本町6-14-45O.Sビル1F,1130,20230909,1100,30
すき家,東京都,すき家 武蔵小金井北口店,東京都小金井市本町5-18-5第55東京ビル,1130,20230909,1100,30
すき家,東京都,すき家 武蔵小山店,東京都品川区小山3-25-13,1250,20230909,1200,50
すき家,愛知県,すき家 武豊IC店,愛知県知多郡武豊町嶋田58-200,1080,20230909,1030,50
すき家,京都府,すき家 伏見石田店,京都府京都市伏見区石田西ノ坪1-9,1050,20230909,1000,50
すき家,福井県,すき家 福井花堂店,福井県福井市花堂北1-2-28,1050,20230909,1000,50
すき家,福岡県,すき家 福岡志免店,福岡県糟屋郡志免町志免東3-1-12,1000,20230909,950,50
すき家,福岡県,すき家 福岡拾六町店,福岡県福岡市西区拾六町1-25-8,1000,20230909,950,50
すき家,福岡県,すき家 福岡渡辺通五丁目店,福岡県福岡市中央区渡辺通5-2-27,1000,20230909,980,20
すき家,福岡県,すき家 福岡博多駅南店,福岡県福岡市博多区博多駅南5-22-16,1000,20230909,980,20
すき家,福岡県,すき家 福岡舞鶴店,福岡県福岡市中央区舞鶴1-2-12,1000,20230909,980,20
すき家,兵庫県,すき家 福崎店,兵庫県神崎郡福崎町南田原字ハツグロ2970-1,1050,20230909,980,70
すき家,広島県,すき家 福山蔵王店,広島県福山市南蔵王町5-16-23,1000,20230909,980,20
すき家,広島県,すき家 福山多治米店,広島県福山市多治米町5-28-13,1000,20230909,980,20
すき家,東京都,すき家 福生店,東京都福生市加美平1-19-7,1130,20230909,1080,50
すき家,福島県,すき家 福島西BP店,福島県福島市東中央3-47-2,980,20230909,930,50
すき家,東京都,すき家 文京白山店,東京都文京区向丘1-10-4,1200,20230909,1150,50
すき家,奈良県,すき家 宝来店,奈良県奈良市菅原町556-1,1000,20230909,980,20
すき家,兵庫県,すき家 豊岡野田店,兵庫県豊岡市野田95-1,1080,20230909,1050,30
すき家,愛知県,すき家 豊橋運動公園前店,愛知県豊橋市豊岡町143-1,1080,20230909,1030,50
すき家,愛知県,すき家 豊橋広小路店,愛知県豊橋市広小路1-37,1080,20230909,1030,50
すき家,愛知県,すき家 豊橋浜道店,愛知県豊橋市浜道町字浜道96-5,1080,20230909,1030,50
すき家,愛知県,すき家 豊川中央通店,愛知県豊川市中央通2-57-1,1100,20230909,1030,70
すき家,東京都,すき家 豊田駅前店,東京都日野市多摩平1-2-26シンデレラビル1F,1130,20230909,1080,50
すき家,福岡県,すき家 北九州空港通り店,福岡県京都郡苅田町大字苅田3787-11,1000,20230909,950,50
すき家,神奈川,すき家 北新横浜店,神奈川県横浜市港北区北新横浜1-4-8,1250,20230909,1200,50
すき家,東京都,すき家 北新宿一丁目店,東京都新宿区北新宿1-12-12サンエスビル1F,1270,20230909,1200,70
すき家,東京都,すき家 北赤羽駅浮間口店,東京都北区浮間3-28-9,1200,20230909,1120,80
すき家,東京都,すき家 北千住西口店,東京都足立区千住3-1-10,1160,20230909,1120,40
すき家,埼玉県,すき家 北本荒井店,埼玉県北本市荒井2-413-1,1080,20230909,1030,50
すき家,愛知県,すき家 北名古屋弥勒寺店,愛知県北名古屋市弥勒寺東3-1,1080,20230909,1050,30
すき家,埼玉県,すき家 本川越クレアモール店,埼玉県川越市新富町1-19-4本川越ASビル1F,1070,20230909,1030,40
すき家,京都府,すき家 槙島店,京都府宇治市槙島町二十四56-3,1050,20230909,1000,50
すき家,千葉県,すき家 幕張店,千葉県千葉市花見川区幕張町5-417-207,1100,20230909,1050,50
すき家,千葉県,すき家 幕張本郷店,千葉県千葉市花見川区幕張本郷6-24-26鈴木本郷ビル1F,1080,20230909,1030,50
すき家,東京都,すき家 末広町店,東京都千代田区外神田6-15-14,1250,20230909,1200,50
すき家,兵庫県,すき家 明幹加古川店,兵庫県加古川市尾上町安田305-1,1050,20230909,1000,50
すき家,兵庫県,すき家 明石駅前店,兵庫県明石市東仲ノ町11-29石ビル1F,1030,20230909,980,50
すき家,兵庫県,すき家 明石西IC店,兵庫県明石市魚住町清水2128-2,1030,20230909,980,50
すき家,兵庫県,すき家 明石大久保IC店,兵庫県明石市大久保町大窪字大澤2700-1,1080,20230909,980,100
すき家,埼玉県,すき家 毛呂山小田谷店,埼玉県入間郡毛呂山町大字小田谷220-1,1080,20230909,1030,50
すき家,千葉県,すき家 木更津店,千葉県木更津市太田4-13,1100,20230909,1050,50
すき家,東京都,すき家 木場店,東京都江東区木場5-11-19達摩堂ビル1F,1250,20230909,1200,50
すき家,愛知県,すき家 木曽川店,愛知県一宮市木曽川町黒田字中沼北ノ切5-2,1100,20230909,1080,20
すき家,東京都,すき家 目黒三丁目店,東京都目黒区目黒3-9-3目黒パークスクエア102号室,1250,20230909,1200,50
すき家,東京都,すき家 目白通り高野台店,東京都練馬区高野台2-5-15,1200,20230909,1150,50
すき家,千葉県,すき家 野田つつみ野店,千葉県野田市つつみ野1-2-4,1100,20230909,1050,50
すき家,千葉県,すき家 野田花井店,千葉県野田市花井200-1,1100,20230909,1050,50
すき家,埼玉県,すき家 嵐山店,埼玉県比企郡嵐山町大字千手堂37-2,1100,20230909,1050,50
すき家,東京都,すき家 立会川店,東京都品川区南大井1-6-10加藤ビル1F,1250,20230909,1200,50
すき家,富山県,すき家 立山利田店,富山県中新川郡立山町利田629-1,1080,20230909,1030,50
すき家,広島県,すき家 立町店,広島県広島市中区立町2-1立町中央ビル1F,1100,20230909,1080,20
すき家,千葉県,すき家 流山江戸川台店,千葉県流山市美原2-137-1,1070,20230909,1030,40
すき家,東京都,すき家 溜池山王店,東京都港区赤坂1-5-2外堀通ビル1F,1320,20230909,1280,40
すき家,茨城県,すき家 竜ヶ崎NT店,茨城県龍ケ崎市久保台1丁目1-1,1020,20230909,980,40
すき家,茨城県,すき家 竜ヶ崎馴柴店,茨城県龍ケ崎市馴柴町718-1,1020,20230909,980,40
すき家,京都府,すき家 龍谷大店,京都府京都市伏見区竹田久保町21-7ビル・マルジョウ,1050,20230909,1000,50
すき家,兵庫県,すき家 龍野店,兵庫県たつの市龍野町富永383-1,1030,20230909,1000,30
すき家,東京都,すき家 練馬関町南店,東京都練馬区関町南1-11-2,1200,20230909,1100,100
すき家,東京都,すき家 練馬南大泉店,東京都練馬区南大泉1-17-17,1200,20230909,1100,100
すき家,東京都,すき家 蓮根駅西店,東京都板橋区蓮根2-29-6蓮根ビル1F,1200,20230909,1120,80
すき家,東京都,すき家 六本木五丁目店,東京都港区六本木5-9-22第2千陽ビル1F,1320,20230909,1280,40
すき家,和歌山,すき家 和歌山榎原店,和歌山県和歌山市榎原字西塩田215-1,1000,20230909,950,50
すき家,和歌山,すき家 和歌山大谷店,和歌山県和歌山市大谷字藤原田87-2,1000,20230909,950,50
すき家,東京都,すき家 糀谷店,東京都大田区南蒲田3-3-1こうじや駅前ビル1F,1250,20230909,1200,50
すき家,東京都,すき家 鶯谷店,東京都台東区根岸1-6-10,1250,20230909,1150,100
