松屋,和歌山,松屋 海南店,和歌山県海南市船尾213-17,980,20230603,950,30
松屋,和歌山,松屋 岩出店/マイカリー食堂 岩出店,和歌山県岩出市岡田4-1,1000,20230603,950,50
松屋,和歌山,松屋 紀ノ川大橋店,和歌山県和歌山市湊1820-99,950,20230603,900,50
松屋,和歌山,松屋 小雑賀店,和歌山県和歌山市小雑賀573-9,1000,20230603,900,100
松屋,大阪府,松屋 大国町店,大阪府大阪市浪速区敷津東1-9-16,1100,20230603,1070,30
松屋,和歌山,松屋 和歌山加納店/松のや 和歌山加納店,和歌山県和歌山市加納295-1（地番）,1000,20230603,950,50
松屋,和歌山,松屋 和歌山向店,和歌山県和歌山市向220-3,950,20230603,900,50
すき家,大分県,すき家 10号宇佐店,大分県宇佐市大字辛島286-1,950,20230603,900,50
すき家,奈良県,すき家 168号生駒壱分店,奈良県生駒市有里町108-1,970,20230603,950,20
すき家,佐賀県,すき家 202号伊万里店,佐賀県伊万里市二里町大里乙102-1,970,20230603,920,50
すき家,佐賀県,すき家 263号佐賀大和IC店,佐賀県佐賀市大和町尼寺3386-1,970,20230603,920,50
すき家,熊本県,すき家 266号宇城松橋店,熊本県宇城市松橋町曲野133-4,970,20230603,930,40
すき家,兵庫県,すき家 29号宍粟店,兵庫県宍粟市山崎町今宿字中筋98-14,1000,20230603,980,20
すき家,兵庫県,すき家 2国姫路市川橋店,兵庫県姫路市市川橋通1-9,1030,20230603,980,50
すき家,兵庫県,すき家 312号姫路砥堀店,兵庫県姫路市砥堀350-2,1030,20230603,980,50
すき家,熊本県,すき家 325号菊池店,熊本県菊池市隈府字北原597-2,950,20230603,920,30
すき家,佐賀県,すき家 34号吉野ヶ里店,佐賀県神埼郡吉野ヶ里町田手1678-16,970,20230603,920,50
すき家,鹿児島,すき家 3号いちき串木野店,鹿児島県いちき串木野市浜ケ城12283-2,970,20230603,920,50
すき家,熊本県,すき家 3号山鹿店,熊本県山鹿市大橋通401-2,970,20230603,920,50
すき家,福岡県,すき家 3号八女店,福岡県八女市本村字荷稲559-1,980,20230603,950,30
すき家,和歌山,すき家 42号海南店,和歌山県海南市船尾264-1,1000,20230603,980,20
すき家,和歌山,すき家 42号新宮神倉店,和歌山県新宮市神倉3-1291-1,1050,20230603,1020,30
すき家,和歌山,すき家 42号田辺店,和歌山県田辺市下万呂362-2,1050,20230603,1000,50
すき家,神奈川,すき家 ノクティプラザ店,神奈川県川崎市高津区溝口1-4-1ノクティプラザ21Fフードコート内,1180,20230603,1140,40
すき家,神奈川,すき家 横浜アリーナ前店,神奈川県横浜市港北区新横浜3-17-20ヒューマンハイム新横浜,1220,20230603,1200,20
すき家,神奈川,すき家 横浜片倉店,神奈川県横浜市神奈川区片倉1-8-6,1180,20230603,1140,40
すき家,神奈川,すき家 下永谷店,神奈川県横浜市港南区下永谷5-1-15,1250,20230603,1150,100
すき家,熊本県,すき家 熊本野中店,熊本県熊本市西区野中1-6-12,980,20230603,960,20
すき家,大阪府,すき家 江戸堀店,大阪府大阪市西区江戸堀1-24-15タツト・肥後橋ビル1F,1180,20230603,1100,80
すき家,神奈川,すき家 高津向ヶ丘店,神奈川県川崎市高津区向ヶ丘147-1,1180,20230603,1140,40
すき家,大阪府,すき家 阪急淡路西口店,大阪府大阪市東淀川区淡路4-11-15井上ビル1F,1100,20230603,1060,40
すき家,兵庫県,すき家 三宮駅東店,兵庫県神戸市中央区雲井通6-1-15サンシティビル103,1060,20230603,1030,30
すき家,兵庫県,すき家 三宮店,兵庫県神戸市中央区北長狭通1-20-2,1060,20230603,1030,30
すき家,神奈川,すき家 鹿島田駅前店,神奈川県川崎市幸区鹿島田1丁目18-6KSビル1F,1200,20230603,1180,20
すき家,大阪府,すき家 十三駅西口店,大阪府大阪市淀川区十三本町1-7-1カネイシビル,1100,20230603,1060,40
すき家,福岡県,すき家 小倉北西港店,福岡県北九州市小倉北区西港町15-70,1000,20230603,950,50
すき家,東京都,すき家 小平上水本町店,東京都小平市上水本町4-12-7,1120,20230603,1080,40
すき家,神奈川,すき家 尻手駅前店,神奈川県川崎市幸区南幸町3-109-1,1200,20230603,1160,40
すき家,神奈川,すき家 新横浜店,神奈川県横浜市港北区新横浜2-6-17,1220,20230603,1200,20
すき家,兵庫県,すき家 神戸鹿の子台店,兵庫県神戸市北区鹿の子台北町8-4-2,1080,20230603,1030,50
すき家,大阪府,すき家 菅原店,大阪府大阪市東淀川区菅原7-5-31,1100,20230603,1060,40
すき家,兵庫県,すき家 西宮北IC店,兵庫県西宮市山口町下山口3-5-23,1080,20230603,1030,50
すき家,大阪府,すき家 西淀川大和田店,大阪府大阪市西淀川区大和田2-1-17,1080,20230603,1050,30
すき家,大阪府,すき家 曽根崎東店,大阪府大阪市北区太融寺町5-8ダイヤモンドレジャ-ビル本館1F,1180,20230603,1130,50
すき家,神奈川,すき家 大倉山駅前店,神奈川県横浜市港北区大倉山1-17-4秋本庄次ビル1F,1180,20230603,1140,40
すき家,大分県,すき家 大分明野店,大分県大分市明野東2-32-26,950,20230603,920,30
すき家,奈良県,すき家 大和高田神楽店,奈良県大和高田市神楽280-2,970,20230603,930,40
すき家,大阪府,すき家 茶屋町店,大阪府大阪市北区茶屋町1-52コモド梅田ビル1F,1180,20230603,1130,50
すき家,長崎県,すき家 長崎銅座町店,長崎県長崎市銅座町6-1銅座松尾ビル1F,970,20230603,950,20
すき家,神奈川,すき家 鶴見市場駅前店,神奈川県横浜市鶴見区市場大和町8-8戸川ビル1F,1180,20230603,1140,40
すき家,大阪府,すき家 天神橋二丁目店,大阪府大阪市北区天神橋2-4-14盛岡ビル1F,1100,20230603,1060,40
すき家,神奈川,すき家 都筑東山田店,神奈川県横浜市都筑区東山田3-18-5,1200,20230603,1140,60
すき家,大阪府,すき家 都島IC店,大阪府大阪市都島区高倉町3-14-27,1080,20230603,1060,20
すき家,大阪府,すき家 都島本通店,大阪府大阪市都島区都島本通3-20-1,1080,20230603,1060,20
すき家,大阪府,すき家 東淀川大桐店,大阪府大阪市東淀川区大桐1-7-8,1080,20230603,1060,20
すき家,大阪府,すき家 内環状守口太子橋店,大阪府守口市緑町3-12,1080,20230603,1060,20
すき家,大阪府,すき家 梅田東店,大阪府大阪市北区堂山町15-15,1180,20230603,1130,50
すき家,福岡県,すき家 博多BP店,福岡県福岡市東区原田3-9-22,1000,20230603,980,20
すき家,兵庫県,すき家 姫路継店,兵庫県姫路市継205-1,1050,20230603,980,70
すき家,兵庫県,すき家 姫路広畑店,兵庫県姫路市広畑区吾妻町3-21,1030,20230603,980,50
すき家,兵庫県,すき家 姫路中地店,兵庫県姫路市飾磨区構2-112,1030,20230603,980,50
すき家,兵庫県,すき家 姫路南条店,兵庫県姫路市南条191-1,1050,20230603,1030,20
すき家,福岡県,すき家 福岡空港店,福岡県糟屋郡志免町別府北1-3-18,1000,20230603,980,20
すき家,神奈川,すき家 保土ヶ谷今井店,神奈川県横浜市保土ヶ谷区今井町600-1,1180,20230603,1140,40
すき家,大阪府,すき家 淀川通塚本店,大阪府大阪市淀川区塚本2-14-19,1100,20230603,1060,40
すき家,兵庫県,すき家 龍野店,兵庫県たつの市龍野町富永383-1,1000,20230603,980,20
すき家,和歌山,すき家 和歌山秋月店,和歌山県和歌山市秋月304-5,1050,20230603,1000,50
